fa'zhan  -  发展
bu'men  -  部门
zheng'fu  -  政府
jing'ji  -  经济
fu'wu  -  服务
gong'si  -  公司
shi'xian  -  实现
shi'chang  -  市场
ping'lun  -  评论
zhi'chi  -  支持
ji'gou  -  机构
neng'li  -  能力
zi'yuan  -  资源
ji'hua  -  计划
xi'tong  -  系统
fen'xiang  -  分享
chan'pin  -  产品
wang'luo  -  网络
ti'sheng  -  提升
bao'gao  -  报告
chan'ye  -  产业
zhi'xing  -  执行
xing'ye  -  行业
xu'qiu  -  需求
diao'zheng  -  调整
fang'an  -  方案
wei'yuan'hui  -  委员会
ji'tuan  -  集团
li'yi  -  利益
zhu'xi  -  主席
jing'ying  -  经营
tong'ji  -  统计
shi'dai  -  时代
li'du  -  力度
shou'ru  -  收入
sheng'tai  -  生态
gou'mai  -  购买
ji'hui  -  机会
jin'nian'lai  -  近年来
tui'chu  -  推出
gui'fan  -  规范
jia'zhi  -  价值
guo'wu'yuan  -  国务院
you'xian'gong'si  -  有限公司
jin'rong  -  金融
chu'tai  -  出台
shu'liang  -  数量
yin'xing  -  银行
min'sheng  -  民生
fei'yong  -  费用
jin'qi  -  近期
feng'xian  -  风险
she'li  -  设立
tong'dao  -  通道
xie'yi  -  协议
chuang'zao  -  创造
qiang'hua  -  强化
cao'zuo  -  操作
sheng'ji  -  升级
xiao'fei  -  消费
jiu'yuan  -  救援
shang'ye  -  商业
cai'zheng  -  财政
mei'yuan  -  美元
sun'shi  -  损失
lv'shi  -  律师
you'hui  -  优惠
tui'jian  -  推荐
tu'po  -  突破
nian'du  -  年度
zhi'li  -  治理
zhu'ce  -  注册
biao'qian  -  标签
pi'zhun  -  批准
kai'tong  -  开通
shang'sheng  -  上升
qu'dao  -  渠道
cha'xun  -  查询
jiao'yi  -  交易
zhi'fu  -  支付
da'cheng  -  达成
cheng'nuo  -  承诺
tao'bao  -  淘宝
huan'bao  -  环保
deng'ji  -  登记
bo'ke  -  博客
qu'shi  -  趋势
pei'zhi  -  配置
lun'tan  -  论坛
wei'gui  -  违规
jin'e  -  金额
diao'yan  -  调研
ji'chang  -  机场
di'yu  -  低于
shang'pin  -  商品
mao'yi  -  贸易
gong'zi  -  工资
neng'yuan  -  能源
zhi'biao  -  指标
ping'gu  -  评估
bao'xian  -  保险
chu'kou  -  出口
tui'chu  -  退出
cai'chan  -  财产
zhuan'ti  -  专题
zong'jing'li  -  总经理
huan'qiu  -  环球
he'tong  -  合同
yan'fa  -  研发
cai'jing  -  财经
shang'zhang  -  上涨
chao'biao  -  超标
dong'shi'zhang  -  董事长
kao'he  -  考核
bu'tie  -  补贴
ji'suan  -  计算
xian'jin  -  现金
fang'di'chan  -  房地产
shang'shi  -  上市
zi'ben  -  资本
dai'kuan  -  贷款
zi'chan  -  资产
xing'qing  -  行情
fen'pei  -  分配
li'cai  -  理财
tou'su  -  投诉
yu'qi  -  预期
xin'hao  -  信号
wei'tuo  -  委托
hong'bao  -  红包
jian'ding  -  鉴定
dang'shi'ren  -  当事人
jing'li  -  经理
an'li  -  案例
yu'suan  -  预算
qi'su  -  起诉
ke'fu  -  客服
te'quan  -  特权
yu'ce  -  预测
cha'ju  -  差距
tai'shi  -  态势
gao'ceng  -  高层
jin'kou  -  进口
fu'dong  -  浮动
qian'jing  -  前景
wei'ruan  -  微软
zong'e  -  总额
pi'lu  -  披露
zuo'tan'hui  -  座谈会
li'run  -  利润
jing'jia  -  竞价
zhi'chu  -  支出
jing'zheng'li  -  竞争力
rong'zi  -  融资
fan'rong  -  繁荣
shen'he  -  审核
gu'fen  -  股份
shou'qu  -  收取
chu'shi  -  初始
zhi'shu  -  指数
xiao'ying  -  效应
fu'li  -  福利
bu'chang  -  补偿
qian'li  -  潜力
duan'qi  -  短期
ji'du  -  季度
pin'zhong  -  品种
ji'bie  -  级别
fu'du  -  幅度
chu'shou  -  出售
huang'jin  -  黄金
chan'quan  -  产权
qi'xian  -  期限
shou'yi  -  收益
ying'xiao  -  营销
shang'wu  -  商务
cai'fu  -  财富
gu'ke  -  顾客
fa'xing  -  发行
cai'wu  -  财务
zhang'hu  -  账户
tou'zi'zhe  -  投资者
shou'sun  -  受损
jiao'na  -  缴纳
shui'shou  -  税收
zhu'guan'bu'men  -  主管部门
huo'bi  -  货币
yan'jiu'yuan  -  研究员
ji'jin'hui  -  基金会
bai'fen'dian  -  百分点
wu'ye  -  物业
te'qu  -  特区
deng'ji  -  等级
ri'qi  -  日期
qi'ye'jia  -  企业家
zhai'wu  -  债务
bi'zhong  -  比重
jue'qi  -  崛起
dai'li  -  代理
diao'kong  -  调控
xie'tong  -  协同
ye'ji  -  业绩
ben'tu  -  本土
nong'chan'pin  -  农产品
shu'e  -  数额
shou'gou  -  收购
zu'lin  -  租赁
chu'bei  -  储备
cha'huo  -  查获
zu'he  -  组合
zhou'qi  -  周期
zhe'shou  -  着手
tong'xun  -  通讯
zheng'quan  -  证券
e'hua  -  恶化
you'yi  -  友谊
ze'ren'ren  -  责任人
zheng'gui  -  正规
guo'ji'hua  -  国际化
liu'tong  -  流通
jiang'jin  -  奖金
gong'gei  -  供给
cai'zheng'bu  -  财政部
xin'yong  -  信用
bei'an  -  备案
juan'kuan  -  捐款
gua'pai  -  挂牌
chou'bei  -  筹备
xia'hua  -  下滑
shang'yue  -  上月
kai'fa'qu  -  开发区
zhuan'qian  -  赚钱
ge'ti  -  个体
shi'chang'hua  -  市场化
ban'kuai  -  板块
cheng'jiao  -  成交
zhong'jie  -  中介
xia'die  -  下跌
zhang'fu  -  涨幅
tai'ping'yang  -  太平洋
shou'hui  -  受贿
chu'qi  -  初期
zhong'xiao'qi'ye  -  中小企业
da'biao  -  达标
chan'liang  -  产量
ding'dan  -  订单
jun'heng  -  均衡
cun'kuan  -  存款
jing'ying'zhe  -  经营者
bo'dong  -  波动
zhao'shang  -  招商
hua'qiao  -  华侨
shen'ji  -  审计
dian'zi'shang'wu  -  电子商务
gu'piao  -  股票
fen'e  -  份额
yi'chan  -  遗产
jie'suan  -  结算
ge'li  -  隔离
ye'jie  -  业界
guo'qi  -  国企
cu'xiao  -  促销
qian'zi  -  签字
long'duan  -  垄断
li'lv  -  利率
she'bao  -  社保
zhao'biao  -  招标
e'du  -  额度
yue'xin  -  月薪
zu'jin  -  租金
he'bing  -  合并
ding'jia  -  定价
di'jia  -  低价
jin'chu'kou  -  进出口
fa'gai'wei  -  发改委
fan'dan  -  反弹
ou'yuan  -  欧元
kong'gu  -  控股
zhuan'rang  -  转让
dan'bao  -  担保
wai'zi  -  外资
wei'zao  -  伪造
zhi'yin  -  指引
ping'jing  -  瓶颈
ding'dian  -  定点
kai'ban  -  开办
gu'dong  -  股东
shang'you  -  上游
fa'ren  -  法人
zhuan'li  -  专利
shou'hui  -  收回
yang'xing  -  央行
xing'tai  -  形态
chou'ji  -  筹集
zhuan'huan  -  转换
xin'dai  -  信贷
yin'xing'ka  -  银行卡
bei'dao  -  被盗
wang'dian  -  网点
zou'shi  -  走势
pan'sheng  -  攀升
cang'ku  -  仓库
gong'shang'ju  -  工商局
chang'fang  -  厂房
jie'gou'xing  -  结构性
jiao'fei  -  缴费
dao'qi  -  到期
hun'he  -  混合
zhao'shang'yin'zi  -  招商引资
bu'zhou  -  步骤
qu'jian  -  区间
can'yu'zhe  -  参与者
shang'hui  -  商会
que'kou  -  缺口
guo'ji'shang  -  国际上
chan'zhi  -  产值
xuan'gao  -  宣告
xia'diao  -  下调
kuan'xiang  -  款项
li'xi  -  利息
guo'min'jing'ji  -  国民经济
huo'li  -  获利
an'quan'xing  -  安全性
kui'sun  -  亏损
cun'fang  -  存放
di'mi  -  低迷
ju'tou  -  巨头
ku'cun  -  库存
xi'na  -  吸纳
kong'huang  -  恐慌
dian'wang  -  电网
shang'diao  -  上调
lei'bie  -  类别
yuan'gao  -  原告
shai'xuan  -  筛选
hua'shang  -  华商
si'da  -  四大
ya'tai  -  亚太
duo'yang'hua  -  多样化
he'zuo'she  -  合作社
kao'liang  -  考量
bao'chou  -  报酬
zeng'zhi  -  增值
gui'hai  -  归还
liu'dong'xing  -  流动性
suo'pei  -  索赔
cai'li  -  财力
ce'liang  -  测量
biao'zhu  -  标注
yu'e  -  余额
hong'li  -  红利
jing'xiao'shang  -  经销商
du'bo  -  赌博
gou'zhu  -  构筑
mo'xing  -  模型
na'shui'ren  -  纳税人
jian'zhi  -  兼职
bo'kuan  -  拨款
kou'chu  -  扣除
fan'hai  -  返还
shou'chuang  -  首创
fu'kuan  -  付款
chang'hai  -  偿还
ji'hui  -  集会
nei'xu  -  内需
yi'an  -  议案
nuo'yong  -  挪用
guan'li  -  惯例
tu'po'kou  -  突破口
nian'hui  -  年会
fu'zhu'xi  -  副主席
mi'du  -  密度
jun'jia  -  均价
xian'zhi  -  闲置
qu'yu'xing  -  区域性
dong'jie  -  冻结
shu'ju'ku  -  数据库
xing'zhang  -  行长
he'zhun  -  核准
yi'ji'du  -  一季度
lou'pan  -  楼盘
zhai'quan  -  债券
guan'ce  -  观测
dong'shi  -  董事
ping'zheng  -  凭证
tuo'qian  -  拖欠
bian'hao  -  编号
tuan'gou  -  团购
qi'pian  -  欺骗
zeng'zhang'lv  -  增长率
bo'yi  -  博弈
li'hao  -  利好
pao'mo  -  泡沫
shi'bo  -  世博
shi'zhan  -  实战
quan'guo'xing  -  全国性
mai'chu  -  卖出
mu'ji  -  募集
tou'ming'du  -  透明度
hui'lv  -  汇率
wen'jian  -  稳健
gou'fang'zhe  -  购房者
xin'yong'ka  -  信用卡
cai'piao  -  彩票
xin'chou  -  薪酬
she'hui'bao'xian  -  社会保险
zhe'kou  -  折扣
ying'bang  -  英镑
tou'biao  -  投标
jin'chang  -  进场
luo'xia  -  落下
cheng'jiao'liang  -  成交量
ri'yuan  -  日元
jiao'yi'suo  -  交易所
ji'he  -  集合
he'ding  -  核定
ji'zhun  -  基准
can'bao  -  参保
zong'shou'ru  -  总收入
po'chan  -  破产
wen'ding'xing  -  稳定性
gui'zhang  -  规章
xiu'zheng  -  修正
jin'tie  -  津贴
biao'sheng  -  飙升
mian'zhi  -  免职
you'jia  -  油价
cha'feng  -  查封
lun'tai  -  轮胎
kai'pan  -  开盘
zou'si  -  走私
wai'hui  -  外汇
mian'chu  -  免除
bao'jia  -  报价
shi'ye'lv  -  失业率
da'zhe  -  打折
zhuan'zhang  -  转账
beng'kui  -  崩溃
bao'xian'gong'si  -  保险公司
hong'guan'diao'kong  -  宏观调控
dai'li'ren  -  代理人
bi'duan  -  弊端
xin'yu  -  信誉
sheng'zhi  -  升值
hei'ming'dan  -  黑名单
you'xiao'qi  -  有效期
shi'hua  -  石化
yu'liu  -  预留
cao'zong  -  操纵
zhang'cheng  -  长城
gu'jia  -  股价
hua'xia  -  华夏
xin'jing'bao  -  新京报
tian'jia  -  天价
wei'yue  -  违约
chi'xu'xing  -  持续性
huan'qiu'shi'bao  -  环球时报
ji'diao  -  基调
fu'jia  -  附加
zhong'cai  -  仲裁
zhu'jiang  -  珠江
xie'zi'lou  -  写字楼
dong'shi'hui  -  董事会
ji'zeng  -  激增
gang'gan  -  杠杆
tou'zi'ren  -  投资人
bo'fu  -  拨付
fen'ge  -  分割
die'fu  -  跌幅
xi'wei  -  席位
yan'qi  -  延期
yang'qi  -  央企
zheng'jian'hui  -  证监会
xing'ye  -  兴业
kui'fa  -  匮乏
zhen'dang  -  震荡
zong'jia  -  总价
mai'dan  -  买单
zeng'zhi'shui  -  增值税
suo'you'quan  -  所有权
piao'ju  -  票据
qi'huo  -  期货
zi'gong'si  -  子公司
jin'rong'ye  -  金融业
hui'kuan  -  汇款
tou'zi'e  -  投资额
duo'mei'ti  -  多媒体
bao'zheng'jin  -  保证金
jia'wei  -  价位
zhi'qing'ren  -  知情人
chou'zi  -  筹资
an'ji'hua  -  按计划
ji'zhuang'xiang  -  集装箱
ji'dian  -  机电
pao'chu  -  抛出
chan'chu  -  产出
bian'zhi  -  贬值
fen'hua  -  分化
zhong'biao  -  中标
cha'jia  -  差价
tong'ji  -  同级
tou'ji  -  投机
he'huo  -  合伙
shou'pan  -  收盘
chou'jiang  -  抽奖
bao'he  -  饱和
a'li'ba'ba  -  阿里巴巴
jie'san  -  解散
huo'zhun  -  获准
jing'ji'wei'ji  -  经济危机
xia'luo  -  下落
ting'zhi  -  停职
zhuan'qu  -  赚取
shen'shen  -  审慎
sheng'chan'neng'li  -  生产能力
bo'yin  -  波音
guan'shui  -  关税
shou'xu'fei  -  手续费
chong'chi  -  充斥
feng'ding  -  封顶
chu'xu  -  储蓄
fu'he  -  复核
jian'hu'ren  -  监护人
bao'zhang  -  暴涨
fen'hong  -  分红
pan'huo  -  盘活
li'pei  -  理赔
she'hui'tuan'ti  -  社会团体
ni'zhuan  -  逆转
hua'er'jie'ri'bao  -  华尔街日报
shi'zhi  -  市值
gang'yuan  -  港元
guan'li'ceng  -  管理层
ting'zhi  -  停滞
wan'da  -  万达
ping'ji  -  评级
gong'bu'ying'qiu  -  供不应求
fu'zhai  -  负债
kou'liu  -  扣留
da'pan  -  大盘
chi'zi  -  赤字
shen'ceng'ci  -  深层次
ou'yuan'qu  -  欧元区
xin'shui  -  薪水
zhong'xin  -  中信
ming'zhu  -  明珠
shou'shi  -  手势
bu'dong'chan  -  不动产
wang'gou  -  网购
guo'zhai  -  国债
tuo'guan  -  托管
bu'ding'qi  -  不定期
qing'suan  -  清算
zhu'ye  -  主业
zhong'guo'yin'xing  -  中国银行
yuan'dong  -  远东
qian'kuan  -  欠款
xie'yi'shu  -  协议书
pian'li  -  偏离
gang'bi  -  港币
bai'yin  -  白银
huang'hai  -  黄海
nian'xin  -  年薪
bao'li  -  暴利
che'hui  -  撤回
jing'ji'ren  -  经纪人
shou'yi'lv  -  收益率
fang'di'chan'ye  -  房地产业
kuan'dai  -  宽带
gou'jin  -  购进
jing'nei'wai  -  境内外
ji'liang  -  计量
hua'yan  -  化验
guo'ji'mao'yi  -  国际贸易
fei'zhi  -  废止
sheng'di  -  圣地
lian'yi  -  联谊
du'chang  -  赌场
tou'zhi  -  透支
fa'qi'ren  -  发起人
bao'fei  -  保费
shang'xing  -  上行
bao'zhi  -  保值
gu'fen'zhi  -  股份制
zhong'shi'hua  -  中石化
fa'huo  -  发货
nan'hang  -  南航
zhong'guan'cun  -  中关村
jiao'yi'e  -  交易额
bu'ban  -  补办
cha'e  -  差额
fu'cai  -  福彩
shou'hui  -  受惠
zhong'xiao'xing  -  中小型
bao'die  -  暴跌
xin'tuo  -  信托
zhi'qing'zhe  -  知情者
dui'wai'mao'yi  -  对外贸易
hui'ji'shi  -  会计师
jing'pen  -  井喷
ben'jin  -  本金
zhong'ou  -  中欧
cheng'yin  -  成因
jing'li'run  -  净利润
jing'mi  -  精密
tong'huo'peng'zhang  -  通货膨胀
tie'xi  -  贴息
wan'li  -  万里
jiao'yi'liang  -  交易量
quan'shang  -  券商
jiao'yi'ri  -  交易日
kua'guo'gong'si  -  跨国公司
yin'jian'hui  -  银监会
xia'dan  -  下单
da'xi'yang  -  大西洋
tao'qu  -  套取
te'xu  -  特许
jin'rong'shi'bao  -  金融时报
zhai'quan  -  债权
kai'hu  -  开户
xi'qian  -  洗钱
dai'li'shang  -  代理商
zhong'hai  -  中海
gou'mai'li  -  购买力
chou'ma  -  筹码
cai'zhang  -  财长
jing'ji'quan  -  经济圈
zi'ben'shi'chang  -  资本市场
gu'min  -  股民
fu'hua'qi  -  孵化器
ding'jin  -  定金
dan'ju  -  单据
hui'kou  -  回扣
ba'gong  -  罢工
nian'bao  -  年报
pan'zhong  -  盘中
ping'jia  -  平价
hua'er'jie  -  华尔街
bao'biao  -  报表
shang'fu  -  上浮
mai'dian  -  卖点
bian'shu  -  变数
fang'dai  -  房贷
zhuan'kuan  -  专款
jian'zhu'ye  -  建筑业
zhong'xi  -  中西
hu'huan  -  互换
bian'mai  -  变卖
gu'zhi  -  股指
gui'gu  -  硅谷
ji'shu'gai'zao  -  技术改造
lian'yun'gang  -  连云港
za'zhi'she  -  杂志社
ji'chu  -  挤出
cai'yang  -  采样
zhai'quan'ren  -  债权人
jia'xi  -  加息
bao'shui  -  保税
dao'qu  -  盗取
xiao'fei'shui  -  消费税
wan'zheng'xing  -  完整性
wo'er'ma  -  沃尔玛
wan'ke  -  万科
shi'chang'bu  -  市场部
jie'yu  -  介于
mei'lian'chu  -  美联储
chang'you  -  畅游
qi'yue  -  契约
fang'dai  -  放贷
mai'dang'lao  -  麦当劳
mian'zhi  -  面值
shui'wu'ju  -  税务局
pei'qian  -  赔钱
fu'te  -  福特
gong'chan'zhu'yi  -  共产主义
an'jie  -  按揭
chi'ka  -  持卡
yuan'qi  -  远期
ji'dian  -  基点
an'yue  -  按月
chao'gu  -  炒股
gong'xing  -  工行
jing'biao  -  竞标
wei'yue'jin  -  违约金
chu'ju  -  出局
zhong'xing  -  中兴
shou'xi'zhi'xing'guan  -  首席执行官
du'zi  -  独资
tie'dao  -  铁道
ying'bi  -  硬币
die'po  -  跌破
cha'dui  -  插队
gao'li'dai  -  高利贷
zhuan'ying  -  专营
gu'jia  -  估价
yi'chu  -  益处
gong'qian  -  工钱
tui'jie'hui  -  推介会
hui'diao  -  回调
chao'zhi  -  超值
suo'you'zhe  -  所有者
di'xiao  -  抵消
yao'jia  -  要价
hei'shou  -  黑手
duan'xian  -  短线
xiao'tiao  -  萧条
chu'tao  -  出逃
jing'li'ren  -  经理人
chu'huo  -  出货
yong'jin  -  佣金
ti'cai  -  体彩
shi'chang'zhan'you'lv  -  市场占有率
hai'er  -  海尔
dong'hang  -  东航
ya'di  -  压低
sun'hao  -  损耗
tu'xing  -  图形
yi'biao  -  仪表
hou'shi  -  后市
fang'kuan  -  房款
shang'zheng  -  上证
zhi'piao  -  支票
zeng'zi  -  增资
zhun'bei'jin'lv  -  准备金率
ding'feng  -  顶峰
fa'xing'liang  -  发行量
dan'chu  -  淡出
shou'kuan  -  收款
kai'men'hong  -  开门红
dao'yong  -  盗用
xie'cheng  -  携程
tu'biao  -  图表
gu'dong  -  古董
mai'fang  -  买方
yao'bai  -  摇摆
zi'ben'jin  -  资本金
shen'gou  -  申购
jie'qia  -  接洽
da'lian'gang  -  大连港
xin'shi'jie  -  新世界
zhu'ying'ye'wu  -  主营业务
xian'huo  -  现货
hui'bao'lv  -  回报率
ao'yuan  -  澳元
zi'ben'zhu'yi  -  资本主义
guo'you'hua  -  国有化
pi'fa'shang  -  批发商
zhang'die  -  涨跌
zhu'ban  -  主板
yu're  -  预热
bu'zhu'jin  -  补助金
shun'cha  -  顺差
nuo'ji'ya  -  诺基亚
ke'xin'du  -  可信度
zu'jie  -  租借
sou'hu  -  搜狐
jin'jiang  -  锦江
mu'gong'si  -  母公司
zhou'qi'xing  -  周期性
xin'tai'jie  -  新台阶
wai'zhai  -  外债
zui'gao'dian  -  最高点
gong'yong'shi'ye  -  公用事业
chong'zhi  -  充值
wang'yin  -  网银
wang'fu'jing  -  王府井
pao'shou  -  抛售
xin'jin  -  薪金
ya'ma'xun  -  亚马逊
ka'hao  -  卡号
bao'xian'ye  -  保险业
zhi'ya  -  质押
tao'xian  -  套现
yi'jia  -  溢价
bu'zu  -  补足
shou'chu  -  收储
lu'jia'zui  -  陆家嘴
ke'kou'ke'le  -  可口可乐
jiu'zhou  -  九州
xu'jia'hui  -  徐家汇
si'qi  -  私企
nian'jin  -  年金
guo're  -  过热
chi'jin  -  吃紧
ben'xi  -  本息
hui'feng  -  汇丰
qing'xiao  -  倾销
jing'zhi  -  净值
yi'zhu  -  遗嘱
yao'yao'ling'xian  -  遥遥领先
bu'rong'le'guan  -  不容乐观
ru'zhu  -  入主
shi'shou  -  失守
cai'tuan  -  财团
ni'shi  -  逆势
jin'niu  -  金牛
pi'wen  -  批文
gu'di  -  谷底
fu'jia'fei  -  附加费
zeng'fa  -  增发
ju'shou  -  拒收
e'er'duo'si  -  鄂尔多斯
guo'an  -  国安
shui'jin  -  税金
nan'yang  -  南洋
zong'xing  -  总行
zhan'huo  -  斩获
cai'zheng'chi'zi  -  财政赤字
bei'shu  -  背书
gui'jin'shu  -  贵金属
shi'chang'ti'xi  -  市场体系
bao'fu  -  暴富
wei'tuo'shu  -  委托书
niu'shi  -  牛市
di'yi'cai'jing'ri'bao  -  第一财经日报
san'hu  -  散户
lian'tong  -  联通
ting'pai  -  停牌
hai'hang  -  海航
fan'yi'fan  -  翻一番
zhong'xing  -  中行
jiu'shi  -  救市
gu'ben  -  股本
bai'yun'ji'chang  -  白云机场
cun'huo  -  存货
shi'xiao'xing  -  时效性
tao'shui  -  逃税
jing'zhi  -  静止
wang'xia  -  网下
wai'bi  -  外币
jin'kuang  -  金矿
wai'xiao  -  外销
jin'tiao  -  金条
bao'jian'hui  -  保监会
liu'dong'zi'jin  -  流动资金
ying'yu  -  盈余
bi'jia  -  比价
you'jia'zheng'quan  -  有价证券
tian'jin'gang  -  天津港
bao'dan  -  保单
jie'qing  -  结清
shou'fu'kuan  -  首付款
zhan'qi  -  展期
guo'min'shou'ru  -  国民收入
gu'wan  -  古玩
fan'zhuan  -  反转
lian'ban  -  联办
jian'shi'hui  -  监事会
hui'gou  -  回购
yi'nian'qi  -  一年期
yi'xiang'shu  -  意向书
zhong'xiao'ban  -  中小板
mian'e  -  面额
yin'lian  -  银联
guo'wang  -  国网
kan'zhang  -  看涨
jing'ji'can'kao'bao  -  经济参考报
jie'kuan'ren  -  借款人
guang'fa  -  广发
cheng'zu'ren  -  承租人
bai'hua  -  百花
rong'tong  -  融通
fang'liang  -  放量
chu'na  -  出纳
bai'yun'shan  -  白云山
zhun'bei'jin  -  准备金
lin'jie  -  临界
ni'cha  -  逆差
chang'zhai  -  偿债
fei'gong'jing'ji  -  非公经济
tui'chang  -  退场
ri'nei  -  日内
tui'shi  -  颓势
tou'piao'quan  -  投票权
ce'yan  -  测验
shu'hui  -  赎回
huo'mian  -  豁免
jin'rong'jie  -  金融界
shuang'kai  -  双开
shen'jiao'suo  -  深交所
tong'pan  -  通盘
jin'rong'jie  -  金融街
qing'chang  -  清偿
da'zhuan  -  打转
qian'bi  -  钱币
gao'sheng  -  高盛
jing'zi'chan  -  净资产
xin'jing'ji  -  新经济
jing'ji'ji'shu'kai'fa'qu  -  经济技术开发区
he'jin  -  合金
chao'fang  -  炒房
yan'sheng'pin  -  衍生品
bo'lang  -  波浪
ri'zhao  -  日照
bao'gang  -  宝钢
jian'shi  -  监事
yi'chu'ji'fa  -  一触即发
jin'rong'ban  -  金融办
zhong'yuan  -  中远
yong'an  -  永安
ruan'zhe'lu  -  软着陆
li'kong  -  利空
ban'cai  -  板材
jin'qiao  -  金桥
dian'xun  -  电讯
zong'shu  -  综述
mo'gen  -  摩根
dong'yin  -  动因
nian'shen  -  年审
ya'hu  -  雅虎
tui'shi  -  退市
ren'shou'bao'xian  -  人寿保险
zhong'nan'cai'jing'zheng'fa'da'xue  -  中南财经政法大学
san'jiao'xing  -  三角形
tuo'pan  -  托盘
ju'chuan  -  据传
ang'si  -  盎司
chu'zi'ren  -  出资人
zhong'guo'yin'jian'hui  -  中国银监会
xin'dai'zi'jin  -  信贷资金
hua'qi  -  花旗
zheng'fu'cai'gou  -  政府采购
jia'ding  -  假定
fu'guo  -  富国
sheng'suan  -  胜算
di'ya'wu  -  抵押物
guo'tai  -  国泰
te'kun'hu  -  特困户
tong'zhang'lv  -  通胀率
yin'xing'jia  -  银行家
shang'qi  -  上汽
bi'feng'gang  -  避风港
zheng'quan'hua  -  证券化
bian'liang  -  变量
pei'shou  -  配售
zhe'jiu  -  折旧
xin'ji'yuan  -  新纪元
mai'jin  -  买进
yi'li  -  伊利
jing'ji'ri'bao  -  经济日报
di'dian  -  低点
pu'fa  -  浦发
chang'fu  -  偿付
tan'di  -  探底
zhe'jia  -  折价
feng'huo  -  烽火
beng'pan  -  崩盘
hu'zhi  -  沪指
yin'shan  -  银山
shou'xian  -  寿险
shang'jiao'suo  -  上交所
bao'e  -  保额
lan'chou'gu  -  蓝筹股
zhu'feng  -  珠峰
ying'zhi'biao  -  硬指标
jin'bei  -  金杯
re'chao  -  热炒
hui'pu  -  惠普
bai'jin  -  白金
tian'an  -  天安
lei'sheng  -  雷声
zhao'shang'ju  -  招商局
jiao'ge  -  交割
mai'duan  -  买断
fen'qi'fu'kuan  -  分期付款
zhao'xing  -  招行
wu'gang  -  武钢
bi'shui  -  避税
qu'tong  -  趋同
ying'te'er  -  英特尔
qi'quan  -  期权
ping'yu  -  评语
zhai'wu'ren  -  债务人
wu'xing'zi'chan  -  无形资产
kai'ta'jin'qu  -  开拓进取
huo'bi'hua  -  货币化
qiang'sheng  -  强生
huo'pi  -  获批
xing'ba'ke  -  星巴克
zhong'guo'ren'min'yin'xing  -  中国人民银行
qian'zhuang  -  钱庄
yi'dong  -  异动
jin'kou'shang  -  进口商
yu'fu'kuan  -  预付款
bi'suo  -  比索
dao'shua  -  盗刷
ci'yue  -  次月
cai'xian  -  财险
jin'ying  -  金鹰
xiao'shou'yi'kong  -  销售一空
guo'jia'wai'hui'guan'li'ju  -  国家外汇管理局
gang'gu  -  港股
can'bao'lv  -  参保率
zhong'yin  -  中银
you'zi  -  游资
tou'zi'fang  -  投资方
san'lian  -  三联
yin'hua'shui  -  印花税
jiao'xing  -  交行
cun'dai'kuan  -  存贷款
jin'cheng  -  金城
zhong'guo'jing'ji'zhou'kan  -  中国经济周刊
wu'jia'zhi'shu  -  物价指数
dan'bao'ren  -  担保人
guang'hua  -  光华
guo'tai'jun'an  -  国泰君安
hei'qian  -  黑钱
chu'kou'shang  -  出口商
feng'kong  -  风控
cang'wei  -  仓位
guo'dian  -  国电
kua'xing  -  跨行
cun'dan  -  存单
ji'nian'zhang  -  纪念章
ju'fu  -  拒付
tong'ji'xue  -  统计学
jing'xi  -  京西
you'zheng'chu'xu  -  邮政储蓄
diao'hui  -  调回
niu'kui'wei'ying  -  扭亏为盈
wo'long  -  卧龙
cai'wu'bu  -  财务部
fa'xing'jia  -  发行价
xiao'fei'lei  -  消费类
da'zhong'xing'qi'ye  -  大中型企业
a'bo'luo  -  阿波罗
hai'ben'fu'xi  -  还本付息
fa'xing'ren  -  发行人
huai'zhang  -  坏账
zhong'jian'shang  -  中间商
guo'yao  -  国药
jia'cha  -  价差
mai'jia  -  卖价
zhong'wen'wang  -  中文网
shang'pin'shi'chang  -  商品市场
shang'pin'hua  -  商品化
shuang'hui  -  双汇
you'xian'quan  -  优先权
da'ren'wu  -  大人物
zong'xu'qiu  -  总需求
xia'xian  -  下陷
dai'er  -  戴尔
dai'xiao  -  代销
zhai'pai  -  摘牌
die'zhi  -  跌至
du'qiu  -  赌球
zi'chan'fu'zhai'biao  -  资产负债表
li'cha  -  利差
hui'se'shou'ru  -  灰色收入
hui'piao  -  汇票
jin'ku  -  金库
jin'ka  -  金卡
jing'zhuan  -  净赚
yue'bao  -  月报
dian'dang  -  典当
feng'xian'tou'zi  -  风险投资
die'shi  -  跌势
tou'ji'zhe  -  投机者
gong'ping'jiao'yi  -  公平交易
cheng'dui  -  承兑
dong'chan  -  动产
guo'huo  -  国货
dao'zhang  -  到账
dang'qi  -  当期
xian'qian  -  闲钱
mei'ri'jing'ji'xin'wen  -  每日经济新闻
qing'cang  -  清仓
lian'hua  -  联华
ji'nian'bi  -  纪念币
bao'shui  -  报税
gu'piao'shi'chang  -  股票市场
chuang'tou  -  创投
gun'xue'qiu  -  滚雪球
an'ri  -  按日
ya'jia  -  压价
wai'gao'qiao  -  外高桥
pai'jia  -  牌价
xiong'shi  -  熊市
zhang'yang  -  长阳
jia'chao  -  假钞
ling'piao  -  领票
hui'chu  -  汇出
ling'xing'tong'zhi  -  另行通知
zhang'yu  -  张裕
xu'shi  -  蓄势
jiao'kuan  -  缴款
ya'xin  -  亚信
guo'xin  -  国信
kong'tou  -  空头
tou'zi'xing  -  投资性
ying'ye'zhi'zhao  -  营业执照
he'zhan'zheng  -  核战争
si'ji'du  -  四季度
hui'shi  -  汇市
he'zi'qi'ye  -  合资企业
cui'shou  -  催收
guang'sha  -  广厦
fei'lv  -  费率
dai'kuan'ren  -  贷款人
pu'zhang  -  普涨
jin'rong'cheng  -  金融城
ke'xue'cheng  -  科学城
chu'xu'ka  -  储蓄卡
gu'xi  -  股息
shou'shi  -  收市
zhan'lüe'jia  -  战略家
fu'zhai'lv  -  负债率
hui'dui  -  汇兑
bi'zhi  -  币值
zhang'bu  -  账簿
tao'lao  -  套牢
kang'jia  -  康佳
mang'mu'xing  -  盲目性
zhong'hua'wang  -  中华网
chu'zu'ren  -  出租人
dian'shu  -  点数
zhai'shi  -  债市
ting'ban  -  停板
jiao'yi'qu  -  交易区
ke'la  -  克拉
hei'jin  -  黑金
mai'tong  -  买通
cheng'xiao  -  承销
hua'an  -  华安
cao'zuo'yuan  -  操作员
dian'dang'xing  -  典当行
zao'pan  -  早盘
yan'huang  -  炎黄
wang'shang  -  网商
chi'ka'ren  -  持卡人
bao'jie  -  宝洁
xin'tuo'gong'si  -  信托公司
qu'xian  -  取现
fang'gao'li'dai  -  放高利贷
ling'yun  -  凌云
chun'jin  -  纯金
qi'lian'shan  -  祁连山
gong'zhai  -  公债
bian'xian  -  变现
fu'xi  -  付息
du'liang  -  度量
wai'hui'guan'li  -  外汇管理
fen'xiao'shang  -  分销商
yi'chan'shui  -  遗产税
jian'shi'zhang  -  监事长
rong'zi'e  -  融资额
jian'ying  -  兼营
jin'rong'shi'chang  -  金融市场
zui'gao'jia  -  最高价
tie'xian  -  贴现
mei'guo'yin'xing  -  美国银行
shang'hai'cai'jing'da'xue  -  上海财经大学
an'gang  -  鞍钢
che'zi  -  撤资
jie'pan  -  接盘
jiu'shi'zhu  -  救世主
kai'ka  -  开卡
hou'che  -  后撤
a'jiao  -  阿胶
jin'rong'gu  -  金融股
jie'hui  -  结汇
wu'xi'dai'kuan  -  无息贷款
ying'xiao'bu  -  营销部
shui'ji  -  税基
dui'chong  -  对冲
hai'long  -  海龙
an'xin  -  安信
ying'huo'chong  -  萤火虫
tong'lian  -  通联
bu'bu'gao  -  步步高
gui'hua'wei  -  规划委
zhong'qian  -  中签
shou'pan'jia  -  收盘价
guo'ji'da'sha  -  国际大厦
ji'zhi'xing  -  机制性
ji'dui  -  挤兑
bi'te  -  比特
kai'pan'jia  -  开盘价
liu'he'cai  -  六合彩
cun'kuan'ren  -  存款人
ping'cang  -  平仓
quan'ju'de  -  全聚德
gong'mu  -  公募
quan'mian'fa'li  -  全面发力
yun'da  -  韵达
ding'li  -  鼎立
yin'jian'ju  -  银监局
zhong'guo'lian'tong  -  中国联通
le'shi'wang  -  乐视网
zhong'guo'jing'ying'bao  -  中国经营报
man'tang'hong  -  满堂红
guo'tou  -  国投
xuan'ze'quan  -  选择权
jin'ma  -  金马
chu'zi'e  -  出资额
cheng'xiao'shang  -  承销商
xin'ka  -  新卡
re'qian  -  热钱
jing'ji'ji'ben'mian  -  经济基本面
tong'huo'jin'suo  -  通货紧缩
te'bie'guan'zhu  -  特别关注
bi'zhong  -  币种
yin'yuan  -  银元
tong'huo  -  通货
sha'die  -  杀跌
gu'fen'you'xian'gong'si  -  股份有限公司
zi'you'jing'zheng  -  自由竞争
xin'da'lu  -  新大陆
zi'chan'fu'zhai'lv  -  资产负债率
zan'xing'ban'fa  -  暂行办法
fen'li'chu  -  分理处
zhang'die'fu  -  涨跌幅
jie'zhi'ri  -  截止日
suo'you'quan'zheng  -  所有权证
shou'jin  -  收进
zhai'quan'guo  -  债权国
hua'xin  -  华新
tian'long  -  天龙
bai'shi'ke'le  -  百事可乐
nong'lin'mu'yu  -  农林牧渔
si'mu  -  私募
hua'xi'cun  -  华西村
shang'yu  -  商誉
qi'hu  -  奇虎
yin'bi  -  银币
chao'di  -  抄底
shi'shi'xi'ze  -  实施细则
jing'ji'xue'jie  -  经济学界
jian'cang  -  减仓
xin'yong'zheng  -  信用证
gou'hui  -  购回
mai'zhu  -  卖主
guan'li'ban'fa  -  管理办法
wan'shi'da  -  万事达
jiao'yi'shang  -  交易商
xing'hua  -  行话
sui'xing'jiu'shi  -  随行就市
ling'die  -  领跌
guo'hua  -  国华
tou'zi'jia  -  投资家
bao'gang  -  包钢
xin'dai'zi'chan  -  信贷资产
hui'yuan  -  汇源
zhong'zhang'xian  -  中长线
bao'xiao  -  包销
fang'xing  -  方兴
gong'si'zhi  -  公司制
shui'xian  -  水仙
zhang'ling  -  长岭
jia'shi  -  嘉实
zheng'quan'fa  -  证券法
xin'cheng'shi  -  新城市
wu'huan  -  五环
wei'pan  -  尾盘
san'nong  -  三农
bu'gao  -  布告
zhong'nong  -  中农
zu'xuan  -  组选
cheng'tou  -  城投
kua'nian'du  -  跨年度
wu'dao'kou  -  五道口
wen'feng  -  文峰
fan'liang'fan  -  翻两番
xin'dai'yuan  -  信贷员
hai'ben  -  还本
jun'xian  -  均线
bao'hu'jia  -  保护价
zhong'guo'guo'hang  -  中国国航
da'dong'hai  -  大东海
da'pan'gu  -  大盘股
shang'she  -  商社
bei'da'huang  -  北大荒
xin'da  -  信达
zong'zhang  -  总账
du'bang  -  杜邦
zhong'cang  -  重仓
dan'jiang  -  丹江
pu'tong'gu  -  普通股
xiang'li  -  香梨
ju'zhi  -  聚酯
fen'san'hua  -  分散化
hui'tong  -  汇通
lao'feng'xiang  -  老凤祥
zi'chan'ping'gu  -  资产评估
ci'ka  -  磁卡
ge'gu  -  个股
bai'da  -  百大
tou'zi'jie  -  投资界
di'kai  -  低开
zhong'bei  -  中北
shang'ye'cheng  -  商业城
qi'shi'ru'hong  -  气势如虹
zhong'shi'you  -  中石油
kou'kuan  -  扣款
shang'zheng'zong'zhi  -  上证综指
ren'he  -  仁和
yuan'shi'ji'lei  -  原始积累
mo'gen'da'tong  -  摩根大通
yan'chao'ji  -  验钞机
yin'xing'jie  -  银行界
jin'rong'zi'chan  -  金融资产
shen'ji'shi  -  审计师
guang'shen'tie'lu  -  广深铁路
zhui'zhang  -  追涨
chu'xu'lv  -  储蓄率
bo'fu  -  波幅
liu'biao  -  流标
hei'bao  -  黑豹
ri'jing'zhi'shu  -  日经指数
jia'cang  -  加仓
ji'fang  -  寄放
zhong'hua  -  中化
nan'wang  -  南网
kuan'xian'qi  -  宽限期
gui'bin'ting  -  贵宾厅
gu'zhi  -  估值
he'gu  -  合股
shang'ye'zhou'kan  -  商业周刊
shou'lou'bu  -  售楼部
jin'ding  -  金鼎
long'hu'bang  -  龙虎榜
ping'gu'shi  -  评估师
pu'fa'yin'xing  -  浦发银行
tou'zi'xing  -  投资型
gui'ji  -  诡计
tian'bao  -  天保
wan'hua  -  万华
su'po'er  -  苏泊尔
chao'die  -  超跌
yin'zhi  -  银质
shi'tai  -  势态
dang'pu  -  当铺
jing'e  -  净额
an'yong  -  安永
tian'hong  -  天弘
zhong'guo'zheng'quan'bao  -  中国证券报
gu'qian'bi  -  古钱币
pei'gu  -  配股
ai'li'xin  -  爱立信
ji'sheng  -  急升
jin'tai  -  金泰
kuang'die  -  狂跌
zhi'zhang  -  滞胀
qiang'dan  -  抢单
fu'li  -  复利
quan'zheng  -  权证
xin'yong'du  -  信用度
bai'jin'ka  -  白金卡
zhong'gu  -  重估
liu'zhuan'shui  -  流转税
zhang'yun  -  长运
ying'tong'huo  -  硬通货
hua'xin  -  华信
wu'zhong  -  吴中
hua'yuan  -  华源
zhong'tie'er'ju  -  中铁二局
nai'ke  -  耐克
chan'cheng'pin  -  产成品
ta'kong  -  踏空
zhong'ji  -  中集
xin'hong'ji  -  新鸿基
zhong'ke  -  中科
xuan'gu  -  选股
dan'bao'fei  -  担保费
ya'ge'er  -  雅戈尔
qun'ju  -  群聚
tong'cheng  -  同城
kai'cang  -  开仓
chu'qing  -  出清
gao'dian  -  高点
zhong'xin'ji'tuan  -  中信集团
bo'feng  -  波峰
feng'xian'xi'shu  -  风险系数
jiao'yin  -  交银
you'xian'gu  -  优先股
wang'tong  -  网通
chuang'zhi  -  创智
xin'ji'zhi  -  新机制
ji'ben'dian  -  基本点
huan'hui  -  换汇
zhong'biao'zhe  -  中标者
cai'zhi  -  财智
zi'zhu'jin  -  资助金
shi'ti'jing'ji  -  实体经济
pian'zhuan  -  偏转
gou'hui  -  购汇
bai'mao  -  白猫
feng'huang'wei'shi  -  凤凰卫视
di'yan  -  递延
kang'da  -  康达
zheng'quan'ri'bao  -  证券日报
shi'de  -  实得
shang'hai'zheng'quan'bao  -  上海证券报
san'li  -  三立
lao'qian  -  老千
kong'gu'you'xian'gong'si  -  控股有限公司
ben'piao  -  本票
ji'min  -  基民
tiao'kong  -  跳空
fen'jie'dian  -  分界点
yin'kai  -  引开
da'niu'shi  -  大牛市
shou'cang'pin  -  收藏品
tou'biao'zhe  -  投标者
min'feng  -  民丰
chi'cang  -  持仓
si'tong  -  四通
chang'he  -  昌河
kui'sun'mian  -  亏损面
chen'xing  -  晨星
ji'jia  -  基价
dai'li'zhi  -  代理制
dian'hui  -  电汇
zhong'xiao'pan'gu  -  中小盘股
zi'ben'mi'ji'xing  -  资本密集型
hong'qiao'ji'chang  -  虹桥机场
zhong'tou'gong'si  -  中投公司
you'chang'zhuan'rang  -  有偿转让
man'cang  -  满仓
hui'shou'qi  -  回收期
suo'liang  -  缩量
ping'gu'fei  -  评估费
bei'fu'jin  -  备付金
hun'ye  -  混业
cai'fu'tong  -  财付通
yin'hua  -  银华
san'yuan  -  三元
hua'guang  -  华光
wan'jia'le  -  万家乐
you'ku'wang  -  优酷网
wai'hui'guan'zhi  -  外汇管制
wai'hui'zi'jin  -  外汇资金
kong'cang  -  空仓
huo'bi'liu'tong  -  货币流通
zhi'chao  -  纸钞
liu'dong'zi'chan  -  流动资产
wai'guan'ju  -  外管局
heng'pan  -  横盘
xing'fa  -  兴发
zhi'sun  -  止损
yi'long  -  艺龙
jiu'long'shan  -  九龙山
ji'qi  -  基期
zhong'fang  -  中房
rui'shi'fa'lang  -  瑞士法郎
chen'ming  -  晨鸣
jian'xin  -  建信
shang'wang  -  商网
zuo'kong  -  做空
zhang'sheng  -  长盛
hong'ji  -  鸿基
jian'cang  -  建仓
wai'pan  -  外盘
chun'yin  -  纯银
chi'bi  -  持币
shan'hang  -  山航
zhu'ce'fei  -  注册费
shi'pan  -  实盘
ban'shui'ting  -  办税厅
ti'zhi'xing  -  体制性
hai'na  -  海纳
da'hua  -  大化
an'lian  -  安联
hei'ka  -  黑卡
jin'ling'fan'dian  -  金陵饭店
tan'xiao  -  摊销
sheng'yu'jia'zhi  -  剩余价值
ban'nian'bao  -  半年报
tian'shi'li  -  天士力
pao'pan  -  抛盘
zheng'quan'shi'bao  -  证券时报
lv'jing  -  绿景
dong'a'a'jiao  -  东阿阿胶
long'ka  -  龙卡
yao'hua  -  耀华
bu'cang  -  补仓
ji'you'gu  -  绩优股
gu'li  -  股利
shi'chang'bao  -  市场报
ti'dan  -  提单
xin'cai  -  新材
chun'lan  -  春兰
chuang'tou'gong'si  -  创投公司
hui'kuan'ren  -  汇款人
jiao'zu  -  缴足
shou'hui  -  售汇
fen'xi'shi  -  分析师
kong'gu'quan  -  控股权
chong'xiao  -  冲销
jing'suan'shi  -  精算师
deng'jia'jiao'huan  -  等价交换
zhi'ya'wu  -  质押物
xiang'long  -  祥龙
sai'di  -  赛迪
hua'xun  -  华讯
shi'ying'lv  -  市盈率
li'la  -  里拉
ling'jun'zhe  -  领军者
ning'bo'gang  -  宁波港
jiao'qiang'xian  -  交强险
shao'shi  -  邵氏
pu'die  -  普跌
guo'ji'yin'xing  -  国际银行
bei'jing'yin'xing  -  北京银行
ding'tou  -  定投
yin'xing'bu  -  银行部
zhong'fang  -  中纺
bo'yin'gong'si  -  波音公司
lai'gang  -  莱钢
shi'tou  -  狮头
chu'chao  -  出超
xing'mei  -  星美
hua'ding  -  华鼎
feng'hua  -  丰华
dui'du  -  对赌
yi'bao  -  易宝
ri'zhao'gang  -  日照港
hong'guan'jing'ji'xue  -  宏观经济学
chi'you'ren  -  持有人
kang'zhu  -  扛住
wei'shi  -  尾市
ke'da  -  科达
dong'sheng  -  东盛
fa'lv'bu  -  法律部
ju'jie  -  具结
dong'xin  -  东信
hong'ye  -  宏业
jin'yin'bi  -  金银币
dan'xuan  -  单选
wu'chang'yu  -  武昌鱼
er'ji'du  -  二季度
ji'zi'kuan  -  集资款
tian'hai  -  天海
dan'bao'fa  -  担保法
gu'gai  -  股改
shou'hui  -  收汇
cai'jing'wang  -  财经网
bo'gu  -  波谷
fa'xing'e  -  发行额
ying'da  -  英达
lv'jian  -  氯碱
qi'you'ji  -  汽油机
dan'bao'jin  -  担保金
xiao'yang  -  小阳
tai'ge  -  泰格
an'quan'du  -  安全度
lei'yi  -  雷伊
she'xiao  -  赊销
hu'shan  -  湖山
jin'rong'bu  -  金融部
shou'yi'ren  -  受益人
hua'diao  -  花雕
ru'shi  -  入市
jian'min  -  健民
jiao'yi'shui  -  交易税
jin'rui  -  金瑞
kai'hu'fei  -  开户费
guo'min'yin'xing  -  国民银行
cang'dan  -  仓单
nan'hua  -  南化
gong'zuo'fang'an  -  工作方案
wei'chao  -  伪钞
wai'hui'zi'chan  -  外汇资产
hua'fu  -  华富
da'yuan  -  大元
dan'ma'xi  -  淡马锡
zhong'zheng  -  中证
xie'cheng'wang  -  携程网
gu'bi  -  古币
huai'zhang'lv  -  坏账率
huang'ye  -  黄页
tian'hong  -  天鸿
san'li  -  三力
nuo'an  -  诺安
zheng'chang'xing  -  正常性
gang'tie'gong'si  -  港铁公司
tai'jiao  -  抬轿
qiao'hui  -  侨汇
xin'gao'dian  -  新高点
shang'ye'yin'xing'fa  -  商业银行法
re'dian'hua'ti  -  热点话题
zhong'guo'tai'bao  -  中国太保
zu'gou  -  租购
huang'jin'chu'bei  -  黄金储备
bai'shi  -  百事
da'mo  -  大摩
ji'lu'yuan  -  记录员
ji'nian'chao  -  纪念钞
yan'jiu'bao'gao  -  研究报告
chong'gao  -  冲高
guo'ji'jin'rong'bao  -  国际金融报
chu'kou'ye  -  出口业
ka'te'er  -  卡特尔
you'bi'ka  -  邮币卡
xin'tian  -  新天
qiu'lin  -  秋林
zhui'shou  -  追收
di'liang  -  地量
jin'guo  -  金果
ya'xing  -  亚星
zhi'gao'dian  -  至高点
fu'quan  -  复权
guo'ku'quan  -  国库券
jin'rong'shi  -  金融史
zong'cheng'jiao'liang  -  总成交量
nong'xing'ka  -  农行卡
fu'guo'yin'xing  -  富国银行
mo'gen'si'tan'li  -  摩根斯坦利
fa'xing'qi  -  发行期
tian'xiang  -  天香
sha'hua  -  厦华
mei'qi'hua  -  煤气化
guo'zi'ju  -  国资局
tan'lu'zhe  -  探路者
dui'jia  -  对价
kang'die  -  抗跌
ka'bao  -  卡包
jin'di  -  金帝
ping'jun'li'run  -  平均利润
zhong'heng  -  中恒
zi'ran'ren  -  自然人
tian'fang  -  天方
fa'ren'gu  -  法人股
bu'ce  -  簿册
dian'wei  -  点位
zhong'guo'jing'ji'shi'bao  -  中国经济时报
kan'die  -  看跌
guo'tong  -  国通
duan'dian  -  断点
fa'bi  -  法币
pu'tian  -  普天
da'biao'zhe  -  达标者
zhong'run  -  中润
yin'tai'bai'huo  -  银泰百货
tou'zi'ye  -  投资业
lv'shi'shi'wu'suo  -  律师事务所
jin'jiao'suo  -  金交所
da'jiang  -  大降
gai'nian'gu  -  概念股
hui'feng'yin'xing  -  汇丰银行
tao'li  -  套利
zhong'guo'qi'ye'jia  -  中国企业家
zhong'lian'zhong'ke  -  中联重科
huo'bi'zhan'zheng  -  货币战争
wu'wu'jiao'huan  -  物物交换
zhong'heng'ji'tuan  -  中恒集团
dong'ruan'ji'tuan  -  东软集团
xue'jia  -  削价
guo'fu'lun  -  国富论
xin'da'zhou  -  新大洲
jing'shun'zhang'cheng  -  景顺长城
shen'shu  -  申赎
shen'bao'lv  -  申报率
pu'ka  -  普卡
ji'zi'e  -  集资额
guan'li'xue'jia  -  管理学家
ji'qi  -  即期
mu'biao'gong'si  -  目标公司
ling'cun'zheng'qu  -  零存整取
zhong'hua'gong'shang'shi'bao  -  中华工商时报
zhong'cang'gu  -  重仓股
bai'hua'cun  -  百花村
he'zuo'xie'yi  -  合作协议
jin'pan  -  金盘
jin'ling  -  金岭
hai'tai  -  海泰
jia'na'da'yuan  -  加拿大元
zhong'xiao'san'hu  -  中小散户
jian'she'yin'xing  -  建设银行
nan'jing'gang  -  南京港
ying'kou'gang  -  营口港
rong'zi'xing  -  融资性
zhe'jiu'lv  -  折旧率
ri'xian  -  日线
zhong'qing'bao  -  中青宝
cun'ding'qi  -  存定期
hua'nan'cheng  -  华南城
hong'sheng  -  宏盛
ya'hu'gong'si  -  雅虎公司
lian'dian  -  联电
bei'ta  -  贝塔
zhan'xun  -  展讯
feng'pan  -  封盘
cheng'xiao'tuan  -  承销团
bao'han  -  保函
xin'nuo  -  信诺
tuo'shou  -  托收
quan'ju'guan  -  全局观
qi'le'cai  -  七乐彩
yun'tian'hua  -  云天化
ren'tou'shui  -  人头税
xiao'ka  -  销卡
wei'guan'jing'ji'xue  -  微观经济学
rui'yin'ji'tuan  -  瑞银集团
zheng'xing  -  正兴
shang'hai'ji'chang  -  上海机场
la'ji'gu  -  垃圾股
yi'tai  -  伊泰
hui'tian  -  惠天
bu'chong'xie'yi  -  补充协议
jun'zi'xie'ding  -  君子协定
ding'shui  -  定税
diao'qi  -  掉期
guo'ci  -  国瓷
hai'fu'tong  -  海富通
xiao'pan'gu  -  小盘股
da'tong'yin'xing  -  大通银行
yi'hua  -  宜华
hai'pu'rui  -  海普瑞
jiao'yi'ting  -  交易厅
shou'ju  -  首局
guo'mei'dian'qi  -  国美电器
jing'shou'ru  -  净收入
ka'zhong  -  卡种
tou'zi'liang  -  投资量
wan'tong'di'chan  -  万通地产
xin'huang'pu  -  新黄浦
zui'di'zhi  -  最低值
tang'shan'gang  -  唐山港
liu'du'qiao  -  六渡桥
shuang'ma  -  双马
huang'jin'bao  -  黄金宝
guo'fa  -  国发
wei'da  -  威达
zhong'qiao  -  中侨
pao'mo'jing'ji  -  泡沫经济
xiao'fei'yang  -  小肥羊
nan'fang'gong'si  -  南方公司
xian'shou'gu  -  限售股
tong'qing  -  同庆
luo'lai'jia'fang  -  罗莱家纺
hui'hua  -  汇划
chao'biao'zhe  -  超标者
du'ma  -  赌马
rui'long  -  瑞龙
xie'diao'bu  -  协调部
kua'guo'yin'xing  -  跨国银行
gong'gu  -  公股
zhang'jiang'gao'ke  -  张江高科
zhong'qing'yin'xing  -  重庆银行
jin'zhi'ling  -  禁止令
tian'fu  -  天富
chan'ye'zi'ben  -  产业资本
jiu'zhou'tong  -  九州通
si'da  -  思达
lan'cun  -  揽存
gu'quan'zhuan'rang'xie'yi  -  股权转让协议
nan'kong  -  南控
xin'hong'ji'di'chan  -  新鸿基地产
jiang'zuan  -  江钻
mai'kao'lin  -  麦考林
gu'ding'zi'ben  -  固定资本
mai'kong  -  卖空
bu'jin  -  补进
ba'ke'lai'yin'xing  -  巴克莱银行
san'pu  -  三普
shuang'bi  -  双币
guang'ming'ru'ye  -  光明乳业
jing'shou'fei  -  经手费
tou'zi'pin  -  投资品
jian'tong  -  建通
pu'yin'an'sheng  -  浦银安盛
gu'yue'long'shan  -  古越龙山
zhong'guo'jian'she'yin'xing  -  中国建设银行
zhu'di  -  筑底
li'cai'zhou'bao  -  理财周报
mei'tan'gu  -  煤炭股
zheng'quan'shi'chang'zhou'kan  -  证券市场周刊
di'ya'lv  -  抵押率
shui'dian  -  税点
nong'hua  -  农化
zhang'ting'ban  -  涨停板
mei'gu  -  美股
ling'shou'fu  -  零首付
mai'jia  -  买价
zhong'guo'shi'hua  -  中国石化
zhong'zi'yin'xing  -  中资银行
tao'hui  -  套汇
biao'sheng  -  飚升
li'xi'lv  -  利息率
hui'feng'ji'tuan  -  汇丰集团
qi'ye'ji'tuan  -  企业集团
meng'niu'ru'ye  -  蒙牛乳业
yin'jian  -  银建
zhuan'ya  -  转押
xian'zhi  -  现值
ji'cha  -  绩差
jin'zhou'gang  -  锦州港
guang'ya  -  光亚
bao'ying  -  宝盈
bei'xin'lu'qiao  -  北新路桥
zu'zhi'ji'gou'dai'ma'zheng  -  组织机构代码证
tong'jun'ge  -  桐君阁
jin'di'ji'tuan  -  金地集团
hai'xin  -  海欣
guo'you'gu  -  国有股
jing'quan  -  颈圈
zhong'guo'shang'bao  -  中国商报
hu'pan  -  护盘
tong'cheng  -  铜城
xu'guang  -  旭光
tuo'pu  -  托普
zhi'jia'ge'shang'pin'jiao'yi'suo  -  芝加哥商品交易所
fa'piao'guan'li'ban'fa  -  发票管理办法
dong'li'yuan  -  动力源
huan'gu  -  换股
gao'xi'lan'cun  -  高息揽存
nan'shun  -  南顺
yuan'da'tou  -  袁大头
gong'si'zhang'cheng  -  公司章程
san'lian'shang'she  -  三联商社
pu'yin  -  浦银
rui'shi'yin'xing  -  瑞士银行
tou'zi'xue  -  投资学
hua'tian'jiu'dian  -  华天酒店
yong'da  -  永大
fu'dan  -  附单
hua'run'ji'tuan  -  华润集团
bo'duan'xing  -  波段性
shang'hai'jin'rong'xue'yuan  -  上海金融学院
zhong'guo'ren'min'bao'xian'gong'si  -  中国人民保险公司
cheng'dou'lu'qiao  -  成都路桥
bo'tong  -  博通
xin'cai'fu  -  新财富
chuan'da'zhi'sheng  -  川大智胜
hui'feng'jin'xin  -  汇丰晋信
pan'hou  -  盘后
lu'tai  -  鲁泰
ping'you  -  平邮
jiang'su'shun'tian  -  江苏舜天
qing'hua'zi'guang  -  清华紫光
jin'jian'mi'ye  -  金健米业
heng'li  -  恒立
tian'hong  -  天宏
nan'jing'yin'xing  -  南京银行
guo'zhong  -  国中
wu'mao  -  物贸
chai'huo  -  拆伙
ai'jian  -  爱建
bao'xin  -  宝信
duo'lun'gu'fen  -  多伦股份
qi'huo'jiao'yi'guan'li'tiao'li  -  期货交易管理条例
cheng'nuo'fei  -  承诺费
wei'jia  -  维加
kong'kai  -  空开
shou'gou'ren  -  收购人
ji'zhang'yuan  -  记账员
shi'jing'lv  -  市净率
guo'lian'an  -  国联安
wei'yue'lv  -  违约率
fu'ri  -  福日
jin'pu  -  金普
fu'dong'hui'lv'zhi  -  浮动汇率制
yan'jiu  -  验旧
si'da'kang  -  斯达康
ti'huo'dan  -  提货单
yin'lv'wang  -  银率网
su'ning'huan'qiu  -  苏宁环球
lang'sha  -  浪莎
chao'hong'ji  -  潮宏基
lu'zhou'lao'jiao'gu'fen'you'xian'gong'si  -  泸州老窖股份有限公司
dao'qi'ri  -  到期日
bao'guang  -  宝光
luo'ke'wei'er  -  罗克韦尔
xue'lai'te  -  雪莱特
zhong'guo'bao'an  -  中国宝安
cheng'zhang'xing  -  成长性
bao'zeng'zhang  -  保增长
zhong'guo'xin'da'zi'chan'guan'li'gong'si  -  中国信达资产管理公司
rong'zi'kuan  -  融资款
da'hua'yin'xing  -  大华银行
sheng'fang  -  圣方
zhi'ya'pin  -  质押品
bao'wang  -  保网
zi'ben'li'de'shui  -  资本利得税
chuang'ye'wang  -  创业网
qi'ye'suo'de'shui'fa  -  企业所得税法
shen'gou'kuan  -  申购款
hu'lian'wang'zhou'kan  -  互联网周刊
shi'dian'fang'an  -  试点方案
jing'lun  -  精伦
wan'shui'zheng  -  完税证
fang'da'te'gang  -  方大特钢
jie'ji  -  借记
xia'gui  -  下轨
jia'zhang  -  假账
zhai'wu'guo  -  债务国
tong'ji'xi  -  统计系
ji'liang'jing'ji'xue  -  计量经济学
chao'hua  -  朝华
guo'jia'tong'ji'ju  -  国家统计局
ye'wu'xian  -  业务线
yan'sheng'chan'pin  -  衍生产品
zeng'zi'e  -  增资额
bu'jia  -  补价
zhong'guo'wang'tong  -  中国网通
kang'da'er  -  康达尔
hua'duan  -  划断
wan'bang'da  -  万邦达
xi'pan  -  洗盘
tong'ji'tang  -  同济堂
guang'lian'da  -  广联达
jiu'long'cang'ji'tuan  -  九龙仓集团
shou'gou'zhe  -  收购者
hua'lian'shang'sha  -  华联商厦
jiang'li'jin  -  奖励金
xin'li'tai  -  信立泰
chao'die'gu  -  超跌股
jing'mao'da'xue  -  经贸大学
jie'chu  -  借出
wan'li'da  -  万利达
ao'you  -  澳优
bao'sheng  -  暴升
lei'jin'shui  -  累进税
he'fei'san'yang  -  合肥三洋
can'yu'jia'zhi  -  残余价值
hui'li  -  汇丽
xin'jin'jiang  -  新锦江
fang'da'ji'tuan  -  方大集团
gang'gu'tong  -  港股通
bao'zi  -  宝姿
xin'dong'fang  -  新东方
chang'yuan  -  昌源
xin'ye  -  锌业
ta'er'si  -  拓尔思
gong'yong'ke'ji  -  公用科技
yin'xing'xue  -  银行学
da'bei'nong  -  大北农
kou'ling'ka  -  口令卡
feng'bi'qi  -  封闭期
xin'lian  -  信联
qian'shou  -  前手
cun'fang'chu  -  存放处
shuang'bi'ka  -  双币卡
nan'bo'ji'tuan  -  南玻集团
ti'e  -  提额
ling'gou'bu  -  领购簿
chu'qian  -  出千
gong'bao  -  共保
chu'jing  -  除净
xin'xiu'li  -  新秀丽
zhong'cai'wang  -  中彩网
di'yi'cai'jing  -  第一财经
he'xun  -  和讯
xin'da'zi'chan  -  信达资产
tai'da'hong'li'ji'jin  -  泰达宏利基金
lun'huan'zhi  -  轮换制
zi'ben'pin  -  资本品
li'cai'jin  -  理财金
zhuan'huan'fei  -  转换费
gu'fen  -  股分
zhong'guo'gong'shang'yin'xing  -  中国工商银行
ju'chao  -  巨潮
hui'dang  -  回档
wu'hu'gang  -  芜湖港
chu'xi  -  除息
jia'rui  -  嘉瑞
fang'yuan  -  方源
zhan'cang  -  斩仓
jin'yuan'bao  -  金元宝
wan'nian'xin  -  万年薪
zhong'fu  -  中服
mei'ya  -  美雅
kuai'gong'si  -  快公司
yan'shen  -  验审
huan'shou'lv  -  换手率
tie'xian'lv  -  贴现率
leng'que'qi  -  冷却期
xiang'gang'jiao'yi'suo  -  香港交易所
yin'guang'xia  -  银广夏
guang'fa'yin'xing  -  广发银行
bei'yin'mei  -  贝因美
ju'you  -  聚友
hua'chang'da  -  华昌达
long'jian  -  龙建
xin'gu  -  新股
tun'ji  -  屯积
sheng'yi'bao  -  生意宝
yi'hua  -  仪化
huang'tai  -  皇台
mai'kong'mai'kong  -  买空卖空
jiang'li'fei  -  奖励费
guo'xiang  -  国祥
yun'ying'bu  -  运营部
hao'sheng  -  豪盛
xia'po  -  下破
zhao'xing'ka  -  招行卡
ju'pi  -  拒批
kang'ka'si'te  -  康卡斯特
xiao'pan  -  小盘
zong'shui'ping  -  总水平
zhi'biao'ti'xi  -  指标体系
gan'hua  -  甘化
liu'tong'gu  -  流通股
fu'li'lv  -  负利率
huan'qiu'qi'ye'jia  -  环球企业家
de'hao'run'da  -  德豪润达
fei'xian'jin  -  非现金
bao'cheng  -  宝诚
bao'rui'tong'dian'dang'xing  -  宝瑞通典当行
guan'lian'gong'si  -  关联公司
shang'tong'ka  -  商通卡
yuan'fa  -  源发
he'hui  -  合会
xian'shi  -  先施
shuang'di  -  双底
xie'xing  -  楔形
xin'han'yin'xing  -  新韩银行
ha'yao'ji'tuan  -  哈药集团
tong'wei'gu'fen  -  通威股份
fa'zhan'gui'hua  -  发展规划
ai'di'xi  -  艾迪西
ou'zhou'huo'bi  -  欧洲货币
ji'chai  -  济柴
fan'xi'qian'fa  -  反洗钱法
bei'hai'gang  -  北海港
jin'rong'ti'zhi  -  金融体制
shang'shi'gui'ze  -  上市规则
zhong'xiao'ban'zhi  -  中小板指
wu'kuang'zheng'quan  -  五矿证券
zu'fang  -  租方
lian'bang'cun'kuan'bao'xian'gong'si  -  联邦存款保险公司
gua'jia  -  挂价
huan'dao  -  寰岛
tou'zi'xie'yi  -  投资协议
re'men'gu  -  热门股
guo'hai'fu'lan'ke'lin  -  国海富兰克林
tian'jin'hai'yun  -  天津海运
ha'er'si  -  哈尔斯
dong'fang'long  -  东方龙
guo'neng  -  国能
hai'li  -  海立
si'chuan'shuang'ma  -  四川双马
an'xin'xin'tuo  -  安信信托
di'jia'gu  -  低价股
bo'xun  -  博讯
jie'pan  -  解盘
ya'hui  -  押汇
tou'zi'qi  -  投资期
jia'de'bao  -  家得宝
fu'bi  -  辅币
tai'da'hong'li  -  泰达宏利
zheng'tai'dian'qi  -  正泰电器
huo'bi'zhu'yi  -  货币主义
dong'fang'guo'xin  -  东方国信
shang'hai'lai'shi  -  上海莱士
yong'ka  -  用卡
xin'hua'jin  -  新华锦
qian'jing  -  钱经
xin'hua'bai'huo  -  新华百货
lian'yi  -  联益
lao'ai'de'yin'xing  -  劳埃德银行
gao'xin'xing  -  高新兴
hai'lan'xin  -  海兰信
mei'li'hua'jiu'dian  -  美丽华酒店
yi'huo'mao'yi  -  易货贸易
ha'yao'gu'fen  -  哈药股份
shen'ji'bao'gao  -  审计报告
an'tai'ji'tuan  -  安泰集团
hua'su  -  华塑
guang'zhou'lang'qi  -  广州浪奇
shou'lou'chu  -  售楼处
xin'zhong'ji  -  新中基
da'you'qi'huo  -  大有期货
jin'ben'wei'zhi  -  金本位制
zhong'ke'san'huan  -  中科三环
tian'quan  -  填权
you'kong  -  诱空
an'da'xin  -  安达信
dong'fang'yu'hong  -  东方雨虹
zhong'hai'you  -  中海油
shou'gou'fang  -  收购方
lian'ming'ka  -  联名卡
lu'yin  -  鲁银
ban'nian'qi  -  半年期
ou'bi'te  -  欧比特
dong'hua'ruan'jian  -  东华软件
long'ke  -  龙科
ke'hua'heng'sheng  -  科华恒盛
sheng'run  -  盛润
ling'xi  -  零息
huan'qiu'cai'jing  -  环球财经
jin'hua  -  金化
tai'bai  -  钛白
jin'kui'hua  -  金葵花
bao'li'hua  -  宝丽华
mo'gao'gu'fen  -  莫高股份
bao'lai'te  -  宝莱特
jing'ban'yuan  -  经办员
bo'xin  -  博信
zhong'liang'tun'he  -  中粮屯河
ji'en'nie'ye  -  吉恩镍业
qing'dao'hai'xin  -  青岛海信
li'ji  -  利记
qi'dong'zi'jin  -  启动资金
sha'long'da  -  沙隆达
hai'neng'da  -  海能达
hang'tian'zhang'feng  -  航天长峰
hai'lun'zhe  -  海伦哲
yin'zhi'jie  -  银之杰
ke'ni'ka  -  柯尼卡
hong'dou'hang'kong  -  洪都航空
ha'li'bo'dun  -  哈里伯顿
an'ju'bao  -  安居宝
su'ning'dian'qi  -  苏宁电器
guang'xia  -  广夏
bao'xi'niao  -  报喜鸟
dan'bi  -  单币
cheng'xin'wang  -  诚信网
bo'hui  -  拨回
zhong'ke'ying'hua  -  中科英华
jiao'tong'yin'xing  -  交通银行
hang'min  -  航民
xia'xin  -  夏新
da'hua'gu'fen  -  大华股份
bing'xiong  -  冰熊
lian'ci  -  联次
qian'bi  -  前笔
su'dai'tong  -  速贷通
kai'ma  -  凯马
gu'ding'hui'lv'zhi  -  固定汇率制
cai'piao'dian  -  彩票点
jiu'yang'gu'fen'you'xian'gong'si  -  九阳股份有限公司
guo'ji'shang'bao  -  国际商报
rang'du  -  让渡
za'pan  -  砸盘
kan'pan  -  看盘
da'hua'nong  -  大华农
chuang'xin'gao  -  创新高
an'cai  -  安彩
huan'qiu'ji'tuan  -  环球集团
bi'sheng'yuan  -  碧生源
fei'zheng'chang'hu  -  非正常户
hui'tong'ji'tuan  -  汇通集团
zheng'quan'wang  -  证券网
pan'gan  -  盘感
xian'dai'chuan'bo  -  现代传播
ying'ye'ri  -  营业日
zhong'yuan  -  中源
mai'fang'shi'chang  -  买方市场
zha'da'yin'xing  -  渣打银行
qing'fang'cheng  -  轻纺城
dan'li  -  单利
hua'hai'yao'ye  -  华海药业
jiao'ge'dan  -  交割单
hui'ci  -  回次
san'ji'du  -  三季度
zhong'guo'kuang'ye  -  中国矿业
hong'bao'li  -  红宝丽
xin'dou'jiu'dian  -  新都酒店
yun'sheng  -  运盛
gao'yi'jia  -  高溢价
pei'e'zhi  -  配额制
zhong'guo'gong'si  -  中国公司
jin'lu'ji'tuan  -  金路集团
jin'rong'xu'ke'zheng  -  金融许可证
quan'qiu'zi'ben'shi'chang  -  全球资本市场
gang'beng'er  -  钢镚儿
zhong'lu  -  中鲁
di'xi  -  低吸
can'lv  -  惨绿
gui'yan'bo'ye  -  贵研铂业
jiao'yi'gui'ze  -  交易规则
dian'li'gu  -  电力股
wai'guo'tou'zi'fa  -  外国投资法
jiao'huo'jia  -  交货价
zi'xuan'gu  -  自选股
jiao'yi'chang  -  交易场
hai'wang'ji'tuan  -  海王集团
mai'mai'he'tong  -  买卖合同
de'mian  -  德棉
zhong'guo'dian'xin  -  中国电信
min'hua  -  民化
gai'piao  -  改票
zhong'guo'jin'rong  -  中国金融
ka'zhong'xin  -  卡中心
yin'qi  -  银期
hai'da'ji'tuan  -  海大集团
hua'gong'gu  -  化工股
shang'gang'ji'tuan  -  上港集团
xin'hua'dou  -  新华都
yin'ji'ji'tuan  -  银基集团
guang'zhou'shi'guang'bai'gu'fen'you'xian'gong'si  -  广州市广百股份有限公司
fang'di'chan'ping'gu  -  房地产评估
dong'fu'long  -  东富龙
ou'ya'ji'tuan  -  欧亚集团
zhong'guan  -  中冠
nan'jing'xin'gang  -  南京新港
zong'he'shui  -  综合税
sha'men'guo'ji'yin'xing  -  厦门国际银行
hai'lian'xun  -  海联讯
zhong'qing'gang'jiu  -  重庆港九
yi'yang'xin'tong  -  亿阳信通
zhong'guo'ren'min'jian'she'yin'xing  -  中国人民建设银行
yi'li'pu  -  伊立浦
qin'feng  -  秦丰
hua'tao  -  华陶
jin'sui'ka  -  金穗卡
shou'quan'shu  -  授权书
fu'cai'zhong'xin  -  福彩中心
meng'fa'li  -  蒙发利
shi'dian'ban'fa  -  试点办法
shang'hai'bei'ling  -  上海贝岭
ping'an'ji'tuan  -  平安集团
xin'guang  -  鑫光
fei'li'da  -  飞力达
an'na'da  -  安纳达
si'ying'gong'si  -  私营公司
zhong'guo'guo'ji  -  中国国际
xin'zhou'bang  -  新宙邦
zhi'shu'hua  -  指数化
shang'hai'fen'xing  -  上海分行
bei'kuang  -  北矿
guang'yu'ji'tuan  -  广宇集团
pu'li'te  -  普利特
pu'min  -  普民
fei'rong'zi'xing  -  非融资性
zhong'hang'san'xin  -  中航三鑫
cao'zuo'zhi'nan  -  操作指南
wu'kuang'jian'she  -  五矿建设
shang'hai'zheng'da  -  上海证大
yun'tong'gong'si  -  运通公司
dian'zi'cheng  -  电子城
zhong'hang'jing'ji  -  中航精机
shan'dong'xin'hua'zhi'yao'gu'fen'you'xian'gong'si  -  山东新华制药股份有限公司
ji'cha'gu  -  绩差股
cheng'dan'zhe  -  承担者
wan'feng'ao'wei  -  万丰奥威
tian'long'ji'tuan  -  天龙集团
wan'jia  -  万家
zhen'ye'ji'tuan  -  振业集团
mei'xin'da  -  美欣达
xin'da'zheng'quan  -  信达证券
heng'tai  -  亨泰
fei'xing'zhe  -  飞行者
xin'xi'ji'shu  -  信息技术
shen'chi'wan  -  深赤湾
bo'hua  -  渤化
hong'feng  -  宏峰
jing'xian'zhi  -  净现值
song'pei  -  送配
xin'tuo'ye  -  信托业
fu'wu'xie'yi  -  服务协议
ju'e'jiao'yi  -  巨额交易
lu'zheng  -  鲁证
zhao'biao'zhe  -  招标者
zhu'xin  -  筑信
tian'yi'bao  -  添益宝
zhan'mu'si'bang'de  -  詹姆斯邦德
zi'ben'hua  -  资本化
zhong'cai'gui'ze  -  仲裁规则
wai'guo'yin'xing  -  外国银行
ka'yang  -  卡样
shen'wan'ke  -  深万科
he'jia  -  禾嘉
hai'li'mei'da  -  海立美达
jin'tong'ling  -  金通灵
dui'fu'qi  -  兑付期
rui'he  -  瑞和
yang'cheng'tong  -  羊城通
bei'yong'fei  -  备用费
jiang'li  -  江力
ru'jia  -  如家
hai'yao  -  海药
tian'yuan'di'ke  -  天源迪科
nei'meng'jun'zheng  -  内蒙君正
hua'sheng'da  -  华盛达
yun'tong'ka  -  运通卡
zhong'guo'jing'ji'wang  -  中国经济网
tuan'ban  -  团办
hong'hua'ji'tuan  -  宏华集团
hua'ling'gang'tie  -  华菱钢铁
zhong'guo'cai'fu  -  中国财富
zong'fang'jia  -  总房价
shou'pan'bao  -  收盘报
duan'rong'quan  -  短融券
hui'bo'pu  -  惠博普
zhong'dian'tou  -  中电投
yi'fang'da  -  易方达
zi'chan'ping'gu'bao'gao  -  资产评估报告
qi'bin'ji'tuan  -  旗滨集团
fu'xi'ri  -  付息日
san'fang'xiang  -  三房巷
xin'cai'jing  -  新财经
zu'zhi'tu  -  组织图
lian'xiang'ji'tuan  -  联想集团
gua'zhang  -  挂帐
ding'tian  -  鼎天
hong'fei'yu  -  红鲱鱼
cai'jing'shi'bao  -  财经时报
min'sheng'zheng'quan  -  民生证券
kang'nai'te  -  康耐特
li'zhu'ji'tuan  -  丽珠集团
si'pu'lin'te  -  斯普林特
chu'bei'tou'cun  -  储备头寸
jin'yu'ji'tuan  -  金宇集团
he'fei'mei'ling'gu'fen'you'xian'gong'si  -  合肥美菱股份有限公司
xian'jin'liu'liang'biao  -  现金流量表
biao'jin  -  标金
jing'yun'tong  -  京运通
sheng'lai'da  -  圣莱达
hai'tong'ji'tuan  -  海通集团
san'li'shi  -  三力士
wan'mei'shi'jie  -  完美世界
zhong'guo'tai'ping  -  中国太平
zhong'guo'tie'jian  -  中国铁建
pu'dong'jin'qiao  -  浦东金桥
shang'po  -  上破
jing'xian  -  颈线
chi'piao'ren  -  持票人
kong'tou'tou'cun  -  空头头寸
wu'liang  -  五粮
suo'cang  -  锁仓
zheng'yong'quan  -  征用权
xiu'shen'tang  -  修身堂
can'zhi  -  残值
jin'yu'che'cheng  -  金宇车城
yuan'dong'jing'ji'ping'lun  -  远东经济评论
da'er'man  -  达尔曼
xiao'shou'he'tong  -  销售合同
ya'zhou'jin'rong  -  亚洲金融
guang'wei'liu'chuan  -  广为流传
yang'gu'hua'tai  -  阳谷华泰
zhong'guo'cai'jing'bao  -  中国财经报
hui'tian'fu  -  汇添富
gang'hua'ran'qi  -  港华燃气
gu'shi'dong'tai'fen'xi  -  股市动态分析
guang'zhou'bai'yun'shan'zhi'yao'gu'fen'you'xian'gong'si  -  广州白云山制药股份有限公司
zi'guang'hua'yu  -  紫光华宇
xin'xi'zao'bao  -  信息早报
hui'tian'jiao'ye  -  回天胶业
hong'tai'yang  -  红太阳
bao'li'shang  -  保理商
zhe'jiang'hai'liang  -  浙江海亮
guo'dian'nan'rui  -  国电南瑞
wei'da'guo'ji  -  维达国际
nei'pan  -  内盘
zong'he'lei  -  综合类
bao'gao'qi  -  报告期
ling'qi'gu'fen  -  零七股份
chuang'ye'ji'hua'shu  -  创业计划书
shi'jie'jing'ji  -  世界经济
san'quan'shi'pin  -  三全食品
zhuan'qi  -  转期
yi'dong'gu  -  异动股
jin'fei'da  -  金飞达
shang'hai'di'chan  -  上海地产
jia'zhao'ye'ji'tuan  -  佳兆业集团
yi'shu'pin'tou'zi  -  艺术品投资
da'ye'te'gang  -  大冶特钢
zhong'guo'yi'dong  -  中国移动
quan'qiu'shang'ye'jing'dian  -  全球商业经典
zhong'qing'ji'dian  -  重庆机电
bai'sheng'ji'tuan  -  百盛集团
jing'li'fei  -  经理费
da'xing'qing  -  大行情
ping'gu'ban'fa  -  评估办法
cha'ku  -  查库
zhong'guo'nan'che  -  中国南车
ren'gou'xie'yi  -  认购协议
zhong'ke'ruan  -  中科软
wang'chun'hua  -  望春花
zhuan'ye'ban  -  专业版
ke'si'wu'de  -  科斯伍德
gang'yan'gao'na  -  钢研高纳
cai'piao'wang  -  彩票网
shi'lian  -  石炼
da'zi'jin  -  大资金
bei'bo'gu'fen  -  北玻股份
jiao'yi'shi'jian  -  交易时间
wan'li'da  -  万力达
you'luo'ka  -  尤洛卡
bei'chen'shi'ye  -  北辰实业
zhang'cheng'ka  -  长城卡
tang'chen'bei'jian  -  汤臣倍健
mai'da'si  -  麦达斯
zhu'ye'ji'tuan  -  株冶集团
lu'run  -  鲁润
ju'fu  -  聚富
zhong'nan'zhong'gong  -  中南重工
bei'shu'ren  -  背书人
shi'xian  -  石岘
bei'jing'li'er  -  北京利尔
er'fang'ji  -  二纺机
yi'shi'da  -  易世达
dong'feng'ji'tuan  -  东风集团
guan'cheng'da'tong  -  冠城大通
hong'zhi  -  宏智
shi'qi  -  仕奇
lan'guang  -  兰光
shen'zhen'zhi'duo'ying  -  深圳智多盈
san'yuan'da  -  三元达
zhong'xin'hai'zhi  -  中信海直
di'ya'he'tong  -  抵押合同
xin'hui  -  信汇
bai'ye  -  白页
du'cai  -  赌彩
jing'cheng'tong'ye  -  精诚铜业
rong'tong'ling'xian  -  融通领先
zhan'lüe'gui'hua  -  战略规划
jiang'su'hong'bao  -  江苏宏宝
xin'jiang'tian'hong  -  新疆天宏
zhong'yin'rong'ye  -  中银绒业
si'zhou'ji'tuan  -  四洲集团
feng'lin'ji'tuan  -  丰林集团
su'ning'huan'qiu'gu'fen'you'xian'gong'si  -  苏宁环球股份有限公司
guang'zhou'fen'xing  -  广州分行
ge'zhou'ba  -  葛州坝
san'feng'zhi'neng  -  三丰智能
shen'zheng'cheng'zhi  -  深证成指
zi'yi  -  自仪
bao'guan'ren  -  保管人
xian'sheng'yao'ye  -  先声药业
liang'yun  -  良运
zhang'dian  -  长电
tian'jin'song'jiang  -  天津松江
guang'dian'yun'tong  -  广电运通
sha'men'wu'ye  -  厦门钨业
kai'di  -  凯地
ji'qi  -  集琦
cang'zhou'da'hua  -  沧州大化
ying'wei'teng  -  英威腾
hua'lan'sheng'wu'gong'cheng'gu'fen'you'xian'gong'si  -  华兰生物工程股份有限公司
gong'yin'ya'zhou  -  工银亚洲
ao'wei'tong'xin  -  奥维通信
zi'ran'ren'gu  -  自然人股
hai'de'gu'fen  -  海德股份
yue'shui'dian  -  粤水电
zheng'ce'mian  -  政策面
shang'hai'gang'lian  -  上海钢联
zhen'hua'gang'ji  -  振华港机
cai'jing'zhou'kan  -  财经周刊
he'chen  -  合臣
jiu'fa  -  九发
ao'pu'guang'dian  -  奥普光电
qi'xing'dian'zi  -  七星电子
ya'ma'dun  -  亚玛顿
leng'guang  -  棱光
cheng'xiao'e  -  承销额
mai'kong  -  买空
hai'ning'pi'cheng  -  海宁皮城
ding'xiang'zeng'fa  -  定向增发
yi'de  -  一德
xin'kai'pu  -  新开普
jin'li'lai'ji'tuan  -  金利来集团
kang'sai  -  康赛
shen'an'da  -  深安达
wu'han'fan'gu  -  武汉凡谷
nan'hua'ji'tuan  -  南华集团
qi'xiang'teng'da  -  齐翔腾达
xu'ji'dian'qi  -  许继电气
tong'xing'quan  -  通行权
fu'feng'ji'tuan  -  阜丰集团
zhong'xin'yin'xing  -  中信银行
qing'hua'tong'fang  -  清华同方
zhong'yuan'xin'tuo  -  中原信托
hang'yi'xian  -  航意险
xin'da'zi'chan'guan'li'gong'si  -  信达资产管理公司
luo'bo  -  洛玻
gao'si'da  -  高斯达
gui'sheng  -  贵绳
shou'jin  -  售尽
ji'lin'sen'gong  -  吉林森工
ya'zhou'huo'bi  -  亚洲货币
fu'shi'yin'xing  -  富士银行
kang'de'xin  -  康得新
tian'hong'bao'ye  -  天鸿宝业
kang'fei'shi'you  -  康菲石油
xin'he'cheng  -  新和成
shen'fa  -  深发
min'fu'fa  -  闽福发
tong'ke  -  通科
guo'tai'jin'long  -  国泰金龙
jiang'zhong'yao'ye  -  江中药业
ban'shui'yuan  -  办税员
xi'wang'tang'ye  -  西王糖业
sun'shi'lv  -  损失率
kai'mei'te'qi  -  凯美特气
wu'xi'shang'de  -  无锡尚德
guo'tai'jin'ying  -  国泰金鹰
xu'zhang  -  虚涨
gong'shang'yin'xing  -  工商银行
tan'mu'jiang  -  谭木匠
fa'ren'yin'xing  -  法人银行
gong'yin'tian'yi  -  工银添颐
ban'cang  -  半仓
jian'kang'xian  -  健康险
shang'jie'ping'lun  -  商界评论
shan'dong'lv'ye  -  山东铝业
hua'qiao'cheng  -  华侨城
bei'jing'guo'tou  -  北京国投
kang'da'shi'pin  -  康大食品
di'chan'gu  -  地产股
man'bu'zhe  -  漫步者
yi'an  -  亿安
huang'jin'tou'zi  -  黄金投资
qiong'min'yuan  -  琼民源
shen'guo'shang  -  深国商
yi'jiao'kuan  -  溢缴款
bao'he'dian  -  饱和点
luo'pu'si'jin  -  罗普斯金
dong'guo  -  东锅
san'mu'ji'tuan  -  三木集团
guo'tai'jin'niu  -  国泰金牛
hai'wang'ying'te'long  -  海王英特龙
dan'bi'ka  -  单币卡
guo'tai'shang'zheng  -  国泰上证
chao'sheng'dian'zi  -  超声电子
gui'dong'dian'li  -  桂东电力
chao'gao  -  炒高
yu'yuan  -  玉源
qi'ming'xin'xi  -  启明信息
mai'fang'shi'chang  -  卖方市场
qian'chuan'zi  -  钱串子
dong'fang'hang'kong  -  东方航空
jin'rong'tou'zi'bao  -  金融投资报
yong'heng'yin'xing  -  永亨银行
he'zhun'zhi  -  核准制
shang'wu'zhou'kan  -  商务周刊
yin'cheng  -  银承
bei'lv  -  北旅
yin'zhai  -  银债
luo'yang'zhou'yan'ke'ji'gu'fen'you'xian'gong'si  -  洛阳轴研科技股份有限公司
guo'ji'jin'rong  -  国际金融
zhong'xin'tai'fu  -  中信泰富
fa'ka'yin'xing  -  发卡银行
hua'fu'se'fang  -  华孚色纺
da'sheng  -  达声
tai'ji'dian  -  台积电
yu'san'xia  -  渝三峡
yin'xing'ka'hao  -  银行卡号
bu'kong  -  补空
zhang'sheng'tong'de  -  长盛同德
xi'dan'shang'chang  -  西单商场
ha'gao'ke  -  哈高科
hu'jian  -  沪建
zhong'hua'yan'tu  -  中化岩土
zhui'suo'quan  -  追索权
ri'ke'hua'xue  -  日科化学
hua'shen'ji'tuan  -  华神集团
hua'an'bao'li  -  华安宝利
kang'mei'yao'ye  -  康美药业
chan'ye'fa'zhan  -  产业发展
shang'hai'kai'bao  -  上海凯宝
gong'yin'tian'li  -  工银添利
hua'wei'dian'zi  -  华微电子
le'dian  -  乐电
ao'ke'gu'fen  -  奥克股份
gong'gei'qu  -  供给区
cai'wu'guan'li  -  财务管理
mai'ke'te  -  麦科特
wei'er'tai  -  威尔泰
tian'yi  -  天仪
gao'jin'shi'pin  -  高金食品
hao'ning'da  -  浩宁达
jian'xing'ka  -  建行卡
lu'zhou'lao'jiao  -  泸州老窖
cheng'gong'ying'xiao  -  成功营销
gui'zhou'bai'ling  -  贵州百灵
li'yuan'lv'ye  -  利源铝业
shen'ji'jie'guo  -  审计结果
jin'rong'shi  -  金融市
shen'yuan'ye  -  深原野
shang'zheng'gu  -  上证股
qing'kuang'biao  -  情况表
gao'xin'fa'zhan  -  高新发展
zhong'guo'yi'yao  -  中国医药
li'bang  -  利邦
zi'zhu'chuang'xin  -  自主创新
sheng'xue'rong  -  圣雪绒
sao'pan  -  扫盘
su'chang'chai  -  苏常柴
jin'jiang'jiu'dian  -  锦江酒店
ji'hua'ji'tuan  -  际华集团
hong'yang'neng'yuan  -  红阳能源
zhong'ye'da  -  众业达
kuo'cang  -  扩仓
guang'dong'xin'hui'mei'da'jin'lun'gu'fen'you'xian'gong'si  -  广东新会美达锦纶股份有限公司
shen'zheng'zong'zhi  -  深证综指
san'te'suo'dao  -  三特索道
bei'tao  -  被套
ku'cang'gu  -  库藏股
shi'yi'da  -  实益达
hai'nan'hai'yao'gu'fen'you'xian'gong'si  -  海南海药股份有限公司
jiu'li'te'cai  -  久立特材
shen'bao'an  -  深宝安
hua'dong'yi'yao'gu'fen'you'xian'gong'si  -  华东医药股份有限公司
wa'zhou  -  瓦轴
san'wei'si  -  三维丝
bao'li'lai  -  宝利来
di'san'bo  -  第三波
shen'da'tong  -  深大通
kong'pan  -  控盘
hua'an'hong'li  -  华安宏利
zhe'jiang'guang'sha  -  浙江广厦
guo'tai'jin'qu  -  国泰进取
sha'men'xin'da  -  厦门信达
dan'bao'pin  -  担保品
ren'tong'ka  -  认同卡
shun'cheng  -  顺诚
fang'gai'fang  -  房改房
da'yin'dan  -  打印单
mu'biao'zhi  -  目标值
luo'bi  -  裸币
xin'ying'xiao  -  新营销
shi'ka  -  实卡
da'ying  -  大盈
ji'zhi  -  吉纸
yi'xin'tai  -  益鑫泰
jin'rong'shi'jie  -  金融世界
zong'ti'er'yan  -  总体而言
fu'li'di'chan  -  富力地产
shen'tian'ma  -  深天马
xie'hui'zhang'cheng  -  协会章程
he'huo'zhi  -  合伙制
gan'feng'li'ye  -  赣锋锂业
ying'te'ji'tuan  -  英特集团
te'bian'dian'gong  -  特变电工
zhe'xian'lv  -  折现率
ji'shu'mian  -  技术面
guo'tou'rui'yin  -  国投瑞银
feng'huo'tong'xin  -  烽火通信
jian'kang'yuan  -  健康元
chang'chai  -  常柴
sha'men'xin'da'gu'fen'you'xian'gong'si  -  厦门信达股份有限公司
hua'shang'yin'xing  -  华商银行
shou'xi'cai'wu'guan  -  首席财务官
da'zhong'li'cai'gu'wen  -  大众理财顾问
bao'jian'zhi  -  保荐制
ha'ci  -  哈慈
yi'cang  -  移仓
dan'cang  -  淡仓
bao'cha  -  报查
sha'xin  -  厦新
jin'gang  -  锦港
ba'yi'gang'tie  -  八一钢铁
xi'piao  -  息票
cao'zuo'gui'fan  -  操作规范
dan'bao'han  -  担保函
jin'bang'ji'tuan  -  金榜集团
shi'xing'biao'zhun  -  试行标准
qiang'ke  -  枪客
fu'hao'jiu'dian  -  富豪酒店
nan'fang'jian'cai'gu'fen'you'xian'gong'si  -  南方建材股份有限公司
fu'wu'he'tong  -  服务合同
ao'fei'dong'man  -  奥飞动漫
gu'piao'ji  -  股票机
nan'zheng  -  南证
lu'yan  -  路演
zhong'ji'an'rui'ke  -  中集安瑞科
jiu'jiu'jiu  -  九九久
chang'feng'che'qiao  -  畅丰车桥
guo'tai'na'zhi  -  国泰纳指
hai'kuan'qi  -  还款期
hua'jing  -  华靖
zhong'tai'hua'xue  -  中泰化学
wai'guo'zhi'jie'tou'zi  -  外国直接投资
jin'hui'ji'tuan  -  金辉集团
ying'guo'jin'rong'shi'bao  -  英国金融时报
nan'bai  -  南百
tao'hui  -  逃汇
bei'jing'fen'xing  -  北京分行
jiu'gui'jiu  -  酒鬼酒
zeng'zhi'shui'pu'tong'fa'piao  -  增值税普通发票
wan'ze'gu'fen  -  万泽股份
dong'guang'ji'tuan  -  东光集团
zhong'guo'jing'ji  -  中国经济
chao'ji'da'le'tou  -  超级大乐透
shuang'ping  -  双平
he'hua  -  河化
ji'jin'he'tong  -  基金合同
die'ting'ban  -  跌停板
bao'mo'gu'fen  -  宝莫股份
wai'hui'bao  -  外汇宝
shang'pin'qi'huo  -  商品期货
xin'xing'shi'chang  -  新兴市场
zheng'quan'tou'zi'ji'jin  -  证券投资基金
chuang'xing'yin'xing  -  创兴银行
xi'cang'tian'lu  -  西藏天路
jiao'zuo'wan'fang  -  焦作万方
ke'lun'yao'ye  -  科伦药业
tian'ma'jing'hua  -  天马精化
yi'liao'bao'jian  -  医疗保健
zhong'yin'guo'ji  -  中银国际
zhe'jiang'fu'yang  -  浙江富阳
bao'tou'lv'ye  -  包头铝业
gou'piao'yuan  -  购票员
shi'lian'hua  -  石炼化
tian'lun'zhi'ye  -  天伦置业
xi'cang'lv'you  -  西藏旅游
bi'de'lin'qi  -  彼得林奇
can'zhi'lv  -  残值率
xiong'zhen  -  雄震
zhong'jin'gong'si  -  中金公司
zhong'xin'shi'ye'yin'xing  -  中信实业银行
hui'duo'li  -  汇多利
bei'jing'tian'qiao  -  北京天桥
e'rong  -  鄂绒
huang'chao'jia'si  -  皇朝家私
die'xing  -  碟型
dai'ping  -  待评
yin'guang'sha  -  银广厦
yun'nan'yan'hua'gu'fen'you'xian'gong'si  -  云南盐化股份有限公司
lian'you  -  联油
jin'li'hua'dian  -  金利华电
xin'hong'ji'gong'si  -  新鸿基公司
hui'tong'tian'xia  -  汇通天下
zhong'guo'nong'ye'yin'xing  -  中国农业银行
ju'li  -  炬力
xi'nan'cai'jing'da'xue  -  西南财经大学
tian'mu'yao'ye  -  天目药业
shang'ti  -  上提
rong'zi'zu'lin'he'tong  -  融资租赁合同
zheng'quan'tou'zi'fen'xi  -  证券投资分析
tong'jin  -  通金
zhong'guo'shi'pin  -  中国食品
ya'xing'hua'xue  -  亚星化学
shi'pan  -  试盘
da'zhong'hua'ji'tuan  -  大中华集团
wei'qiao'fang'zhi  -  魏桥纺织
zhang'sheng'huan'qiu  -  长盛环球
heng'tai'da'tong  -  恒泰大通
ke'da'ji'dian  -  科达机电
zhong'hang'ke'gong  -  中航科工
xi'long'hua'gong  -  西陇化工
nan'ning'tang'ye'gu'fen'you'xian'gong'si  -  南宁糖业股份有限公司
shen'sai'ge  -  深赛格
jin'feng'jiu'ye  -  金枫酒业
ying'hua  -  英化
xin'xin  -  鑫新
guang'fa'zheng'quan  -  广发证券
zhong'guo'guo'ji'zhao'biao'wang  -  中国国际招标网
xiao'pai  -  小牌
yin'xing'quan  -  银行券
zhang'sheng'ji'jin  -  长盛基金
li'yue'jiu'dian  -  丽悦酒店
zu'qi  -  租契
lan'lv  -  兰铝
mo'zhi'hua  -  茉织华
shang'hai'shi'hua  -  上海石化
xin'jia'lian  -  新嘉联
song'liao'qi'che  -  松辽汽车
lang'bo'de'jie  -  朗伯德街
fa'piao'ling'gou'bu  -  发票领购簿
shen'fang'zhi  -  深纺织
xian'shou'qi  -  限售期
su'wu  -  苏物
shen'yin'wan'guo  -  申银万国
ya'hu'cai'jing  -  雅虎财经
tian'ran'jian  -  天然碱
yan'jiu'jian'bao  -  研究简报
jiao'ge'ri  -  交割日
yi'hua'di'chan  -  宜华地产
xin'hua'yin'xing  -  新华银行
qian'jiang'mo'tuo  -  钱江摩托
shou'guan'ri  -  收官日
zhong'qing'chuan'yi  -  重庆川仪
mei'lian'ji'tuan  -  美联集团
xin'xi'wang  -  新希望
wan'shun'chang  -  万顺昌
tong'dao'zhi  -  通道制
zheng'quan'shi'chang'hong'zhou'kan  -  证券市场红周刊
mei'lian'yin'xing  -  美联银行
kai'fang'jing'ji  -  开放经济
hai'kuan'ji'hua  -  还款计划
yu'neng  -  豫能
zhong'hua'guo'ji  -  中化国际
jin'pu'ka  -  金普卡
nan'jing'hong'tai'yang'gu'fen'you'xian'gong'si  -  南京红太阳股份有限公司
guo'tai'jin'ding  -  国泰金鼎
shi'ji'kong'zhi'ren  -  实际控制人
ta'ri'xin'neng  -  拓日新能
yi'hua'mu'ye  -  宜华木业
gou'mai'qu  -  购买区
tong'zhi'qi  -  通知期
lu'tai'fang'zhi'gu'fen'you'xian'gong'si  -  鲁泰纺织股份有限公司
jing'gong'ji'tuan  -  精工集团
shang'hai'zheng'quan'jiao'yi'suo  -  上海证券交易所
shen'wu'ye  -  深物业
he'fu'hui'huang  -  合富辉煌
liu'dong'dian'xun  -  流动电讯
tian'jin'pu'lin  -  天津普林
hai'ge'tong'xin  -  海格通信
shang'hai'mei'lin  -  上海梅林
ke'xin'ji'dian  -  科新机电
ya'tian'ni  -  雅天妮
zhong'hai'da  -  中海达
wu'mao'zhong'xin  -  物贸中心
guo'ji'tou'zi  -  国际投资
shang'dian  -  上电
zhao'shang'ju'guo'ji  -  招商局国际
xi'nan'he'cheng  -  西南合成
xin'ao'ran'qi  -  新奥燃气
shi'shi'biao'zhun  -  实施标准
shang'hai'jin'ling  -  上海金陵
mei'hua'san  -  梅花伞
lian'zu'fang  -  廉租房
ji'gou'tou'zi'zhe  -  机构投资者
yi'chuan'mei  -  壹传媒
yi'lian'zhong  -  易联众
yun'nan'ma'long  -  云南马龙
jing'ji'guan'cha'wang  -  经济观察网
zhong'guo'lian'he'shang'bao  -  中国联合商报
zhong'ke'jian  -  中科健
qu'yu'xing  -  区域型
long'tou'gu  -  龙头股
zhong'guo'shang'ren  -  中国商人
shou'gong'piao  -  手工票
zhong'guo'jian'zhu  -  中国建筑
bo'dong'xing  -  波动性
zhong'hang'guang'dian  -  中航光电
xing'da'guo'ji  -  兴达国际
shuang'zhang'hu  -  双账户
tai'jin'ka  -  钛金卡
zi'ben'hua'lv  -  资本化率
jia'zhi  -  佳纸
chai'gu  -  拆股
zhong'yi  -  重仪
gu'ge  -  股歌
wen'yin'shi  -  文印室
tang'tao  -  唐陶
xin'hua'ji'jin  -  新华基金
jin'hua  -  锦化
ya'ge  -  雅戈
dang'dai'jin'rong'jia  -  当代金融家
san'pu'yao'ye  -  三普药业
xi'bei'zhou'cheng'gu'fen'you'xian'gong'si  -  西北轴承股份有限公司
ping'jun'li'lv  -  平均利率
dong'kong  -  东控
shen'hua'fa  -  深华发
dang'dai'jing'li'ren  -  当代经理人
hu'bei'mai'ya  -  湖北迈亚
wan'chang'ke'ji  -  万昌科技
guang'zhou'guo'guang  -  广州国光
zhong'he'tai'bai  -  中核钛白
jing'ji'dao'kan  -  经济导刊
shou'sun'zhe  -  受损者
long'xing'hua'gong  -  龙星化工
tai'jing'yin'xing  -  泰京银行
zhong'guo'shi'you  -  中国石油
guo'tai'jin'lu  -  国泰金鹿
tiao'xing'tu  -  条形图
zhe'jiang'san'hua'gu'fen'you'xian'gong'si  -  浙江三花股份有限公司
an'kai'ke'che  -  安凯客车
ting'ye'tong'zhi'shu  -  停业通知书
zhong'guo'zhong'qi  -  中国重汽
guo'yan'wang  -  国研网
jin'li'tong  -  金利通
hao'shi'guang  -  好时光
shou'yi'bao  -  收益宝
yong'li'dai'ye  -  永利带业
shen'zhen'bi'ke  -  深圳比克
shang'hai'feng'huang  -  上海凤凰
quan'zhi  -  权智
tian'run'qu'zhou  -  天润曲轴
shi'de'huan'qiu  -  实德环球
xin'tai  -  新太
tian'li'gao'xin  -  天利高新
shan'dong'lu'yang'gu'fen'you'xian'gong'si  -  山东鲁阳股份有限公司
zhen'xin  -  振新
zhong'dan  -  重单
shang'hai'lv'xin  -  上海绿新
qing'niao'hua'guang  -  青鸟华光
ji'cha'gong'si  -  绩差公司
er'fang  -  二纺
an'hui'hua'xing'hua'gong'gu'fen'you'xian'gong'si  -  安徽华星化工股份有限公司
ji'jin'wei'yuan'hui  -  基金委员会
tou'piao'men  -  投票门
dong'wu'jia'he  -  东吴嘉禾
feng'xian'ti'shi  -  风险提示
xin'jin'hua  -  新锦华
zhen'xian'jie  -  针线街
zhong'guo'guo'mao  -  中国国贸
yan'tai'an'lun'gu'fen'you'xian'gong'si  -  烟台氨纶股份有限公司
dong'fang'ming'zhu  -  东方明珠
guo'ji'jin'rong'shi'chang  -  国际金融市场
bei'jing'jun'zheng  -  北京君正
ren'gu'qi'quan  -  认沽期权
qing'suan'xie'yi  -  清算协议
dui'zhao'biao  -  对照表
ping'jia'ti'xi  -  评价体系
hua'qi'yin'xing  -  花旗银行
jie'bao  -  借报
ji'wei'niao  -  几维鸟
shen'shen'fang  -  深深房
guan'li'you'xian'gong'si  -  管理有限公司
ji'shi'wang  -  计世网
guang'zhou'leng'ji  -  广州冷机
zheng'guan'chu  -  征管处
dong'yuan'dian'qi  -  东源电器
hui'tong'neng'yuan  -  汇通能源
guang'dong'xing'hu  -  广东星湖
bei'jing'lv'you  -  北京旅游
heng'tong'guang'dian  -  亨通光电
cheng'shang'ji'tuan  -  成商集团
qi'xing'tie'ta  -  齐星铁塔
hai'wai'tou'zi'fa  -  海外投资法
shen'zhen'shi'tong'chan'li'xing'gu'fen'you'xian'gong'si  -  深圳市通产丽星股份有限公司
chu'piao'ren  -  出票人
shang'hai'wu'mao  -  上海物贸
shi'gu  -  实股
shang'hai'ke'hua'sheng'wu'gong'cheng'gu'fen'you'xian'gong'si  -  上海科华生物工程股份有限公司
shen'tai  -  深泰
jiao'huo'dan  -  交货单
chang'sheng'wang  -  常胜网
tong'cheng'kong'gu  -  通程控股
duan'cang  -  短仓
shang'hai'dian'li  -  上海电力
shan'dong'wei'da  -  山东威达
tai'fu  -  泰复
sha'men'sha'gong  -  厦门厦工
bo'hai'yin'xing  -  渤海银行
da'lian'leng'dong'ji'gu'fen'you'xian'gong'si  -  大连冷冻机股份有限公司
wan'xiang'de'nong  -  万向德农
chao'hui'zhe  -  炒汇者
you'da'guang'dian  -  友达光电
nan'you'wu'ye  -  南油物业
qi'huo'gong'si  -  期货公司
shuang'pei  -  双赔
shan'dong'heng'bang'ye'lian'gu'fen'you'xian'gong'si  -  山东恒邦冶炼股份有限公司
chu'kou'ren  -  出口人
chi'fu  -  迟付
tou'biao'shu  -  投标书
ping'gu'biao'zhun  -  评估标准
tai'jin  -  钛金
guo'ji'rong'zi  -  国际融资
guang'da'bao'de'xin  -  光大保德信
zhong'rui'si'chuang  -  中瑞思创
pu'yin'an'sheng'ji'jin  -  浦银安盛基金
hai'zheng'yao'ye  -  海正药业
sheng'jing'shan'he  -  胜景山河
song'gu  -  送股
ming'tai'lv'ye  -  明泰铝业
sou'yu'te  -  搜于特
wan'neng  -  皖能
yin'zheng'tong  -  银证通
he'xing'ji'tuan  -  合兴集团
ji'lin'hua'xian  -  吉林化纤
gui'bao'ke'ji  -  硅宝科技
fu'dan'fu'hua  -  复旦复华
yun'nan'bai'yao  -  云南白药
pu'tian'shou'yi  -  普天收益
ren'gu'quan'zheng  -  认沽权证
hei'long'gu'fen  -  黑龙股份
you'a'gu'fen  -  友阿股份
zhang'sheng'tong'xi  -  长盛同禧
han'yu'bo'de  -  瀚宇博德
fen'pei'fang'an  -  分配方案
xin'long'guo'ji  -  新龙国际
zhong'guo'ping'an  -  中国平安
dong'fang'jin'yu  -  东方金钰
zhong'liao  -  中辽
ji'li'qi'che  -  吉利汽车
tou'zi'yu'he'zuo  -  投资与合作
duo'jia  -  多佳
hu'nan'hai'li  -  湖南海利
zhong'guo'tou'zi  -  中国投资
hai'xin'dian'qi  -  海信电器
hua'bei'zhi'yao  -  华北制药
hei'se'xing'qi'wu  -  黑色星期五
da'chuang  -  达创
long'shuang  -  龙双
ying'tang'zhi'kong  -  英唐智控
jia'run'duo  -  家润多
zhong'guo'zhong'wang  -  中国忠旺
tong'ji'bao'gao  -  统计报告
dui'zhang'dan  -  对账单
wai'hui'tong  -  外汇通
xin'da'qi'huo  -  信达期货
shang'hai'jian'gong  -  上海建工
kong'zhong'wang  -  空中网
ya'ju'le'di'chan  -  雅居乐地产
xing'ye'ka  -  兴业卡
xin'xi'pi'lu'zhi'du  -  信息披露制度
da'yin'xing  -  大银行
ao'yun'ka  -  奥运卡
pian'xian  -  骗线
pu'luo'kang'yu  -  普洛康裕
su'wei'fu  -  苏威孚
jing'ji'fa'zhan  -  经济发展
shan'dong'kuang'ji  -  山东矿机
guang'bai'gu'fen  -  广百股份
zheng'quan'zhou'kan  -  证券周刊
tou'zi'zhe'guan'xi  -  投资者关系
gu'piao'jie  -  股票界
zhu'xiao'hu  -  注销户
su'san'shan  -  苏三山
huang'chao'jia'si  -  皇朝家俬
wang'fu  -  网付
bai'jin'ban  -  白金版
an'nian  -  按年
nian'shou'yi  -  年收益
zhong'ke'he'chen  -  中科合臣
tian'long'guang'dian  -  天龙光电
shen'hua'xin  -  深华新
li'pin'shui  -  礼品税
rong'zi'wang  -  融资网
shen'zhen'ji'chang  -  深圳机场
ge'ren'li'cai  -  个人理财
xin'jiang'tian'ye  -  新疆天业
zhong'guo'ke'ji  -  中国科技
lian'dong'ji'zhi  -  联动机制
xian'dai'jiao'yu  -  现代教育
dai'kuan'xie'yi  -  贷款协议
jing'tou'yin'tai  -  京投银泰
rong'xin'da  -  融信达
hua'ding'jin'lun  -  华鼎锦纶
luo'yang'bo'li  -  洛阳玻璃
hai'yuan'ji'xie  -  海源机械
pu'luo'gu'fen  -  普洛股份
ji'nuo'er  -  吉诺尔
wan'jia'ji'jin  -  万家基金
hai'luo'xing'cai  -  海螺型材
xing'li'ji'tuan  -  兴利集团
bu'bian'yi  -  不便宜
feng'xian'ti'shi'han  -  风险提示函
zhong'yuan'te'gang  -  中原特钢
gao'yin'di'chan  -  高银地产
da'xiao'tiao  -  大萧条
shang'hai'yi'yao  -  上海医药
guo'lian'xin'tuo  -  国联信托
tong'da'ka  -  通达卡
ha'tou'gu'fen  -  哈投股份
xin'wei'guo'ji  -  新威国际
zi'xun'bao'gao  -  咨询报告
jin'ye'gong'si  -  金业公司
yan'hu'ji'tuan  -  盐湖集团
tian'qiao'bai'huo  -  天桥百货
zhong'shun'jie'rou  -  中顺洁柔
jin'quan'ye  -  津劝业
yi'da  -  奕达
jing'gong'gang'gou  -  精工钢构
diao'cha'jie'guo  -  调查结果
an'lian'ji'tuan  -  安联集团
xin'bei'yang  -  新北洋
yun'hai'jin'shu  -  云海金属
cai'fu'shi'bao  -  财富时报
fa'zhan'zhan'lüe  -  发展战略
guo'tai'jin'ma  -  国泰金马
ha'fei'hang'kong  -  哈飞航空
zhong'guo'ke'jian'gu'fen'you'xian'gong'si  -  中国科健股份有限公司
yue'hong'yuan  -  粤宏远
ri'xian'tu  -  日线图
jin'rui'ke'ji  -  金瑞科技
zhong'yan  -  中燕
hu'bei'yi'hua  -  湖北宜化
ye'wu'fa'zhan  -  业务发展
shang'hai'ke'ji  -  上海科技
hu'bei'sha'long'da'gu'fen'you'xian'gong'si  -  湖北沙隆达股份有限公司
dui'wai'zi  -  对外资
jin'zhong'zi  -  金种子
wan'wei'guo'ji  -  万威国际
jing'shi'jiao'yu  -  警示教育
yi'ji  -  易基
xin'jiang'jin'feng'ke'ji'gu'fen'you'xian'gong'si  -  新疆金风科技股份有限公司
cai'jue'ye  -  采掘业
shang'wu'ying'yu  -  商务英语
mian'dai'li'fei  -  免代理费
zhong'guo'guo'ji'xin'tuo'tou'zi'gong'si  -  中国国际信托投资公司
nan'jing'gang'gu'fen'you'xian'gong'si  -  南京港股份有限公司
shou'yu'zhe  -  授予者
zhong'guo'feng'huang  -  中国凤凰
lu'an'huan'neng  -  潞安环能
zhi'ling'bu  -  指令部
mei'li'zhi'ye  -  美利纸业
jin'rong'feng'bao  -  金融风暴
ka'fei'er  -  卡菲尔
feng'huang'cai'jing  -  凤凰财经
bo'yong  -  拨用
zhuan'huan'jia'zhi  -  转换价值
zhong'fu'shi'ye  -  中孚实业
yong'jia'ji'tuan  -  永嘉集团
jie'suan'ping'zheng  -  结算凭证
hang'tian'ke'ji  -  航天科技
zi'chang'xing  -  自偿性
ning'bo'yun'sheng  -  宁波韵升
chuang'ye'jiao'yu  -  创业教育
da'fu'ke'ji  -  大富科技
yi'fang'da'ji'jin  -  易方达基金
yu'xin'yi'cheng  -  宇信易诚
hang'qi'lun  -  杭汽轮
lin'zhou'zhong'ji  -  林州重机
san'jing'yin'xing  -  三井银行
zhong'guo'you'se'jin'shu  -  中国有色金属
hua'li'chuang'tong  -  华力创通
hei'bai'cai  -  黑白菜
ju'long'guan'ye  -  巨龙管业
zhong'yang'jie'suan'gong'si  -  中央结算公司
jing'ji'zeng'zhang  -  经济增长
hong'li'tong'zhi'shu  -  红利通知书
chu'xu'quan  -  储蓄券
guang'dong'bai'ling'xin  -  广东百灵信
yun'nan'yan'hua  -  云南盐化
du'yue'han  -  杜约翰
te'bie'cuo'shi  -  特别措施
jin'rong'wei'ji  -  金融危机
hua'run'jin'hua  -  华润锦华
ping'jia'zhi'biao  -  评价指标
dong'fang'yin'xing  -  东方银星
li'duo'xiao'xi  -  利多消息
kao'he'zhi'biao  -  考核指标
jing'ji'xue'shu  -  经济学术
si'chuan'hu'shan  -  四川湖山
min'feng'te'zhi  -  民丰特纸
zheng'quan'yi'jia  -  证券溢价
chu'shou'fang  -  出售方
ge'ling  -  格令
yin'he'yin'tai  -  银河银泰
de'lei'si'dun'yin'xing  -  德累斯顿银行
si'chuan'sheng'da  -  四川圣达
fan'san'fan  -  翻三番
cai'jing'lun'tan  -  财经论坛
zhang'kong  -  长控
si'chuan'jing'ji'ri'bao  -  四川经济日报
zhong'ji'ji'tuan  -  中集集团
rong'zi'xie'yi  -  融资协议
zhe'jiang'yong'qiang  -  浙江永强
xin'lang'cai'jing  -  新浪财经
heng'tai'ai'pu  -  恒泰艾普
nan'fang'hang'kong  -  南方航空
xin'cheng'si'ji'hong  -  信诚四季红
zhi'qu'ping'zheng  -  支取凭证
guo'xin'zheng'quan  -  国信证券
jin'ma'gu'fen  -  金马股份
xin'di'dian  -  新低点
hui'feng'jin'xin'long'teng  -  汇丰晋信龙腾
li'wen'ji'tuan  -  理文集团
zhong'guo'ren'shou  -  中国人寿
zhong'xin'kong'gu  -  中信控股
tou'zi'can'kao  -  投资参考
you'xiao'shi'chang'jia'shuo  -  有效市场假说
ping'gu'fang'an  -  评估方案
dong'hua'neng'yuan  -  东华能源
huo'bi'yin'xing'xue  -  货币银行学
shen'zhen'fang'da  -  深圳方大
shang'hai'fu'ren  -  上海辅仁
ke'yong'zi'chan  -  可用资产
lian'hua'he'xian  -  联华合纤
shi'pin'yin'liao  -  食品饮料
shou'tuo'ren  -  受托人
pan'yu'tai'ye  -  攀渝钛业
shen'neng  -  深能
feng'xian'guan'li  -  风险管理
hua'rong'zi'chan'guan'li'gong'si  -  华融资产管理公司
zhong'heng'dian'qi  -  中恒电气
tian'guang'xiao'fang  -  天广消防
zhong'guo'xing'ji'tuan  -  中国星集团
fa'lang'qu  -  法郎区
su'zhou'heng'jiu  -  苏州恒久
quan'qiu'shang'ye  -  全球商业
jin'shan'ruan'jian  -  金山软件
zhong'guo'xi'dian  -  中国西电
jia'ge'gai'ge  -  价格改革
lai'ying'da  -  莱英达
xin'hua'cai'jing  -  新华财经
zhe'jiang'hai'na  -  浙江海纳
shang'hai'hai'long'ruan'jian'gu'fen'you'xian'gong'si  -  上海海隆软件股份有限公司
fu'dao'qi  -  辅导期
wei'sheng'ji'tuan  -  威胜集团
an'quan'guan'li  -  安全管理
shang'hai'xin'mei  -  上海新梅
sun'yi'biao  -  损益表
ping'quan  -  平券
de'xin'ji'tuan  -  德信集团
huan'kang'ji'tuan  -  环康集团
chuang'ye'ban  -  创业板
tang'mu'xun'lu'tou  -  汤姆逊路透
shen'gao  -  深高
cai'jing'pin'dao  -  财经频道
guang'zhou'zhu'jiang  -  广州珠江
jiao'yi'chi  -  交易池
cai'wu'bao'biao  -  财务报表
xin'de'ji'tuan  -  信德集团
wan'xiang'ji'tuan  -  万象集团
xian'shou  -  现手
shen'zhen'shi'hai'wang'sheng'wu'gong'cheng'gu'fen'you'xian'gong'si  -  深圳市海王生物工程股份有限公司
fen'xing'zhi  -  分行制
you'bang'hua'tai  -  友邦华泰
ya'kong  -  轧空
bo'ruan  -  博软
jin'rui'kuang'ye  -  金瑞矿业
ming'xing'dian'li  -  明星电力
yao'hui  -  邀会
si'chuang  -  四创
shou'fei'shou'ju  -  收费收据
nan'shan'lv'ye  -  南山铝业
guan'li'gong'si  -  管理公司
cun'kuan'bao'xian'zhi'du  -  存款保险制度
xi'ci'hu'tong  -  西祠胡同
zhang'cheng'ji'tuan  -  长城集团
fang'zheng'fu'bang  -  方正富邦
shen'zhen'shi'zheng'tong'dian'zi'gu'fen'you'xian'gong'si  -  深圳市证通电子股份有限公司
zhang'bai'ji'tuan  -  长百集团
zhong'yin'ka  -  中银卡
shang'hai'gang'ji  -  上海港机
guo'lian'an'shuang'xi  -  国联安双禧
ren'gou'quan'zheng  -  认购权证
zhang'hu'biao  -  账户表
jie'jue'fang'an  -  解决方案
shan'dong'lu'yang  -  山东鲁阳
nong'shang'she  -  农商社
zheng'quan'dao'bao  -  证券导报
xin'tuo'he'tong  -  信托合同
xin'hai'yi  -  新海宜
lu'shi'hua  -  鲁石化
shun'fa'heng'ye  -  顺发恒业
bei'jing'hua'lian  -  北京华联
he'fei'bai'huo  -  合肥百货
gou'mai'mei'guo  -  购买美国
ge'shi'he'tong  -  格式合同
xi'an'lv'you  -  西安旅游
zhong'guo'shui'wu  -  中国水务
tian'hong'yong'ding  -  天弘永定
hong'an'ji'tuan  -  宏安集团
guo'xing'guang'dian  -  国星光电
zha'da'ji'tuan  -  渣打集团
nan'guo'zhi'ye  -  南国置业
guang'zhou'wan'long  -  广州万隆
long'yuan'dian'li  -  龙源电力
zong'fu'zhai  -  总负债
cao'zuo'liu'cheng  -  操作流程
zhong'he'hua'yuan'tai'bai'gu'fen'you'xian'gong'si  -  中核华原钛白股份有限公司
jiao'dian'wen'ti  -  焦点问题
shen'te'li  -  深特力
zhong'guo'bei'che  -  中国北车
dong'fang'yin'xing  -  东方银行
guang'qi'zhang'feng  -  广汽长丰
wu'han'kai'di'dian'li'gu'fen'you'xian'gong'si  -  武汉凯迪电力股份有限公司
zhong'qing'tong'jun'ge'gu'fen'you'xian'gong'si  -  重庆桐君阁股份有限公司
sai'ge'san'xing  -  赛格三星
ying'mei  -  鹰美
hua'chang'hua'gong  -  华昌化工
zhao'mu'shuo'ming'shu  -  招募说明书
gu'cheng'wang  -  股城网
tou'zi'zhi'nan  -  投资指南
ying'fei'ta  -  英飞拓
xin'fu'yao'ye  -  鑫富药业
da'dong'nan  -  大东南
dong'fang'bao'ben  -  东方保本
jia'nei'quan'zheng  -  价内权证
wu'kuang'fa'zhan  -  五矿发展
guo'yang'xin'neng  -  国阳新能
bei'man'te'gang  -  北满特钢
jin'hai'gu'fen  -  金海股份
jiang'su'fang'zhi  -  江苏纺织
hua'feng'ji'tuan  -  华丰集团
wei'ke'jing'hua  -  维科精华
fu'xing'xiao'cheng  -  福星晓程
zhuo'yue'kong'gu  -  卓悦控股
da'qin'tie'lu  -  大秦铁路
hua'yuan'di'chan  -  华远地产
jin'yu'gu'fen  -  金隅股份
ding'sheng'tian'gong  -  鼎盛天工
xin'wen'ji'tuan  -  新闻集团
chuan'hua'gu'fen'you'xian'gong'si  -  川化股份有限公司
dai'ling'ren  -  代领人
sha'men'guo'mao  -  厦门国贸
ji'shu'tiao'jian  -  技术条件
jin'cheng'gu'fen  -  金城股份
shen'zhen'chi'wan'gang'hang'gu'fen'you'xian'gong'si  -  深圳赤湾港航股份有限公司
zai'xian'zi'xun  -  在线咨询
qian'dai'wang  -  钱袋网
zhong'dian'guan'zhu  -  重点关注
tang'chen'ji'tuan  -  汤臣集团
ke'zai'sheng'neng'yuan  -  可再生能源
luo'ping'xin'dian  -  罗平锌电
shang'ye'yin'xing  -  商业银行
liu'dong'zi'jin'liang  -  流动资金量
an'hui'an'na'da'tai'ye'gu'fen'you'xian'gong'si  -  安徽安纳达钛业股份有限公司
tian'jin'yi'qi'xia'li'qi'che'gu'fen'you'xian'gong'si  -  天津一汽夏利汽车股份有限公司
xin'jiang'tun'he  -  新疆屯河
bai'yuan'ku'ye  -  百圆裤业
ya'xia'qi'che  -  亚夏汽车
an'tai'ke'ji  -  安泰科技
wen'ti'jie'da  -  问题解答
san'ling'yin'xing  -  三菱银行
jin'ma'ji'tuan  -  金马集团
si'fang'da  -  四方达
rui'li'ji'tuan  -  瑞立集团
wei'yi'da'ji'tuan  -  伟易达集团
ren'ding'biao'zhun  -  认定标准
pai'xi'ri  -  派息日
ji'cheng'dian'zi  -  积成电子
lun'dun'jin  -  伦敦金
shen'zhen'hai'wang'xing'chen  -  深圳海王星辰
wen'shang'wang  -  温商网
zheng'quan'shi'chang  -  证券市场
qi'quan'fei  -  期权费
bao'long'di'chan  -  宝龙地产
ji'dian'gu  -  机电股
zhuo'yue'li'cai  -  卓越理财
te'qu'jing'ji  -  特区经济
zhe'jiang'hai'liang'gu'fen'you'xian'gong'si  -  浙江海亮股份有限公司
yuan'gong'chi'gu'ji'hua  -  员工持股计划
fan'hai'jiu'dian  -  泛海酒店
feng'shen'gu'fen  -  风神股份
shuang'se'qiu  -  双色球
feng'zhu'fang'zhi  -  凤竹纺织
jing'ji'zheng'ce  -  经济政策
ji'nan'chai'you'ji'gu'fen'you'xian'gong'si  -  济南柴油机股份有限公司
jin'yuan'mi'ye  -  金源米业
tian'mu'yao  -  天目药
zhong'qing'zhong'yao  -  重庆中药
shen'bao'heng  -  深宝恒
wei'tuo'dan  -  委托单
si'chuan'dian'qi  -  四川电器
shan'mei'guo'ji  -  山煤国际
ping'jia'zhong'xin  -  评价中心
hai'wang'sheng'wu  -  海王生物
ci'xin'gu  -  次新股
rui'shi'yin'xing'gong'si  -  瑞士银行公司
tou'zi'shou'cang  -  投资收藏
shui'shou'jiao'kuan'shu  -  税收缴款书
zhong'qing'hua'ya  -  重庆华亚
fan'kui'dan  -  反馈单
qi'lu'shi'hua  -  齐鲁石化
ao'xin'yin'xing  -  澳新银行
ba'kong  -  把控
hua'shang'chan'ye  -  华商产业
si'lun'bei'xie  -  斯伦贝榭
gao'xin'zhang'tong  -  高新张铜
hong'ye'ji'tuan  -  宏业集团
kai'er'xin'cai  -  开尔新材
nan'tian'xin'xi  -  南天信息
nan'jing'xin'bai  -  南京新百
zhang'sheng'zhong'zheng  -  长盛中证
zhong'guo'jing'ji'bao'gao  -  中国经济报告
guo'tai'shuang'li  -  国泰双利
xian'dai'shang'ye'yin'xing  -  现代商业银行
nan'ning'tang'ye  -  南宁糖业
ning'xia'heng'li  -  宁夏恒力
gong'ying'hua  -  公营化
tian'he'guang'neng  -  天合光能
lu'zheng'wei  -  鲁政委
xin'da'di'chan  -  信达地产
mai'chao  -  卖超
yin'zi'qian  -  印子钱
shen'zhi  -  深值
shen'gao'su  -  深高速
cai'wu'bao'gao  -  财务报告
chan'quan'dao'kan  -  产权导刊
cai'hui'xin'bao  -  财会信报
shang'hai'dian'qi  -  上海电气
xin'she  -  新设
teng'bang'guo'ji  -  腾邦国际
feng'zhuan'kai  -  封转开
si'ren'yin'xing  -  私人银行
bei'di  -  备抵
san'an'guang'dian  -  三安光电
jiao'dian'hua'ti  -  焦点话题
jiao'zuo'wan'fang'lv'ye'gu'fen'you'xian'gong'si  -  焦作万方铝业股份有限公司
hua'long'ji'tuan  -  华龙集团
da'zhong'jiao'tong  -  大众交通
shang'hai'ji'dian  -  上海机电
chao'dong'gu'fen  -  巢东股份
yan'sheng'quan'zheng  -  衍生权证
shen'zhen'guo'ji  -  深圳国际
jiao'yi'mi'ma  -  交易密码
cai'wu'hui'ji  -  财务会计
bei'hai'ji'tuan  -  北海集团
min'jian'jie'dai  -  民间借贷
nan'fang'hui'tong'gu'fen'you'xian'gong'si  -  南方汇通股份有限公司
jie'neng'jian'pai  -  节能减排
jing'li'run'lv  -  净利润率
xing'ye'biao'zhun  -  行业标准
zhong'jiang'di'chan  -  中江地产
quan'quan'xin'tuo  -  全权信托
de'guo'an'lian  -  德国安联
bei'lu'yao'ye  -  北陆药业
zhong'hang'zhong'ji  -  中航重机
bei'ya'ji'tuan  -  北亚集团
mai'duan'xing  -  买断型
jiang'su'wu'zhong  -  江苏吴中
bao'li'da'zi'chan  -  保利达资产
zhe'da'hai'na  -  浙大海纳
jing'ji'za'zhi  -  经济杂志
san'wu'hu'lian  -  三五互联
zhao'shang'ju'zhong'guo'ji'jin  -  招商局中国基金
tou'zi'you'dao  -  投资有道
jin'ma'tou'piao  -  金马投票
lian'hua'chao'shi  -  联华超市
ha'dong'li  -  哈动力
hua'sheng'gu'fen  -  华升股份
yin'xing'xing'zhang  -  银行行长
zhuan'huan'jia'ge  -  转换价格
xin'gui'ding  -  新规定
si'jie'huan'qiu  -  思捷环球
gao'sheng'ji'tuan  -  高盛集团
pu'tian'zhai'quan  -  普天债券
jin'chao'yang'ji'tuan  -  金朝阳集团
bei'jing'ke'rui  -  北京科锐
zi'xin'zheng'ming  -  资信证明
chan'pin'jie'shao  -  产品介绍
zhong'wu  -  中钨
duan'de  -  短的
xin'ye'fang'zhi  -  新野纺织
zhong'lian'zhai  -  中联债
xin'tuo'tou'zi  -  信托投资
jin'rong'da'jie  -  金融大街
tai'guang  -  太光
ai'lüe'te'bo'lang'li'lun  -  艾略特波浪理论
su'zhou'gu'de  -  苏州固锝
lian'bang'po'chan'fa  -  联邦破产法
zong'cheng'ben  -  总成本
qiao'xing'huan'qiu  -  侨兴环球
xing'quan'jia  -  行权价
dong'fang'tong'xin  -  东方通信
rong'zi'fang'an  -  融资方案
sheng'yang'gu'fen  -  圣阳股份
hui'bao'ji'tuan  -  汇宝集团
nei'bu'zi'liao  -  内部资料
gong'si'zhi'li  -  公司治理
ling'shou'yin'xing  -  零售银行
zhong'fang'ji  -  中纺机
da'zhi'hui  -  大智慧
jin'gu'gu'fen  -  金固股份
bu'cheng'wen'fa  -  不成文法
gu'piao'shi'jia  -  股票市价
bu'ke'che'xiao  -  不可撤销
jin'cha'ji'bian'qu'yin'xing  -  晋察冀边区银行
tong'zhou'dian'zi  -  同洲电子
li'he'gu'fen'you'xian'gong'si  -  力合股份有限公司
sha'gong'gu'fen  -  厦工股份
xu'ni'ka  -  虚拟卡
hua'yang'ke'ji  -  华阳科技
long'di'gu'fen  -  龙涤股份
yuan'wang'gu  -  远望谷
zu'he'tou'zi  -  组合投资
di'yi'shi'pin  -  第一食品
guo'tong'gu'fen  -  国统股份
guo'ji'jie'suan  -  国际结算
shi'hua'zhai  -  石化债
kang'mei'zhai  -  康美债
yin'xing'cheng'dui'hui'piao  -  银行承兑汇票
bai'li'dian'qi  -  百利电气
shou'li'ren  -  受理人
zhong'gang'ji'tan  -  中钢吉炭
mo'gen'cai'tuan  -  摩根财团
hai'nan'hang'kong  -  海南航空
tong'hua'shun  -  同花顺
hu'bei'hua'xin  -  湖北华新
ji'feng'nong'ji  -  吉峰农机
te'xu'quan'shui  -  特许权税
mei'yuan'qu  -  美元区
da'leng  -  大冷
yang'hong'ge  -  杨红革
nan'bo'wang  -  南博网
dong'fang'dian'ji  -  东方电机
hua'run'zhi'di  -  华润置地
shen'ji'yi'jian  -  审计意见
tai'guang'dian'xin  -  太光电信
su'wu'mao  -  苏物贸
lv'yue'bao'han  -  履约保函
jin'zhi'ke'ji  -  金智科技
shi'quan'ye  -  石劝业
zhong'guo'guan'li'chuan'bo'wang  -  中国管理传播网
hua'zi'shi'ye  -  华资实业
cheng'pin'ying'cai  -  诚聘英才
su'liao'chao  -  塑料钞
jin'rong'ti'xi  -  金融体系
gong'si'li'cai  -  公司理财
tou'zi'zu'he  -  投资组合
ji'lin'zhi'yao'gu'fen'you'xian'gong'si  -  吉林制药股份有限公司
da'zhong'tou'zi  -  大众投资
zhong'guo'you'se'jin'shu'bao  -  中国有色金属报
jiao'yao'shi  -  交钥匙
zhong'chuan'guo'ji  -  中川国际
zhong'guo'gu'shi  -  中国股市
jin'bao'tong  -  金宝通
min'dian  -  岷电
wei'li'gu  -  微利股
yu'tai'bai  -  渝钛白
shan'tui'gu'fen  -  山推股份
xiang'yang'qi'che'zhou'cheng'gu'fen'you'xian'gong'si  -  襄阳汽车轴承股份有限公司
kai'di'dian'li  -  凯迪电力
mei'guo'guo'ji  -  美国国际
guang'dong'ke'de  -  广东科德
shen'zhen'mai'rui  -  深圳迈瑞
ba'wang'tiao'kuan  -  霸王条款
ha'te'fu  -  哈特佛
gao'te'li  -  高特利
bao'li'di'chan  -  保利地产
sheng'tai'nong'ye  -  生态农业
jing'ji'tong'ji  -  经济统计
shi'chang'gong'qiu  -  市场供求
sha'men'lu'qiao  -  厦门路桥
fu'shun'te'gang  -  抚顺特钢
si'gu  -  死股
gao'jia'gu  -  高价股
zhong'guo'bao'gao'da'ting  -  中国报告大厅
sai'ge'da'sheng  -  赛格达声
yin'ji'fa'zhan  -  银基发展
yu'tai'di'chan  -  渝太地产
fa'piao'ling'gou'ben  -  发票领购本
zhe'shang'yin'xing  -  浙商银行
shang'hai'jia'hao  -  上海佳豪
wen'shi'ji'tuan  -  温氏集团
zhong'fang'gu'fen  -  中房股份
zhong'pan'gu  -  中盘股
kang'sheng'gu'fen  -  康盛股份
guo'ji'shou'zhi  -  国际收支
zhu'yi'li'jing'ji  -  注意力经济
cai'chan'bao'xian  -  财产保险
nan'kai'ge'de  -  南开戈德
ri'dai  -  日贷
an'quan'bian'ji  -  安全边际
dong'bai'ji'tuan  -  东百集团
shen'zhen'neng'yuan  -  深圳能源
xin'lai'ying'cai  -  新莱应材
qian'he'tong  -  签合同
jiang'su'kuang'da  -  江苏旷达
zhuan'pei'gu  -  转配股
fu'wu'ying'xiao  -  服务营销
si'wei'tu'xin  -  四维图新
lu'zhi'ye  -  鲁置业
yue'xiu'tou'zi  -  越秀投资
zhong'ou'ding'li  -  中欧鼎利
qing'long'guan'ye  -  青龙管业
fan'xi'qian  -  反洗钱
hong'shan'zi'ben  -  红杉资本
jing'ying'li'nian  -  经营理念
jia'shi'ke'ji  -  佳士科技
de'sheng'zeng'li  -  德盛增利
zhang'tong  -  张铜
zhong'guo'zhong'tie  -  中国中铁
zheng'ce'gong'ju  -  政策工具
nei'bu'kong'zhi  -  内部控制
hu'nan'you'se'jin'shu  -  湖南有色金属
hui'feng'jin'xin'ji'jin  -  汇丰晋信基金
zheng'quan'zi'xun  -  证券资讯
zhong'guo'shui'ye'ji'tuan  -  中国水业集团
pu'tian'zhai  -  普天债
wu'zhou'ming'zhu  -  五洲明珠
shuang'jian'gu'fen  -  双箭股份
shou'jie'hui  -  收结汇
shang'hai'jin'rong  -  上海金融
fa'kuan'lv  -  罚款率
zhang'cheng'te'gang  -  长城特钢
jiang'hai'gu'fen  -  江海股份
he'bei'gang'tie  -  河北钢铁
xiang'guo'guo'ji  -  橡果国际
yin'xing'guan'li  -  银行管理
zhong'ke'chuang'ye  -  中科创业
shang'hai'pu'tian  -  上海普天
zhong'guo'zi'ben'shi'chang  -  中国资本市场
she'bao'ji'jin  -  社保基金
su'chang'yuan'dong  -  苏常远东
zhong'guo'yuan'yang  -  中国远洋
zhang'sheng'tong'rui  -  长盛同瑞
cai'xin'tong  -  财信通
da'qing'hua'ke  -  大庆华科
zhong'pu  -  中葡
cheng'tou'kong'gu  -  城投控股
jin'feng'ke'ji  -  金风科技
sha'la'li  -  莎拉李
ka'fu'shi'pin  -  卡夫食品
hai'nan'sheng'xin'tuo'tou'zi'gong'si  -  海南省信托投资公司
ru'gu'xie'yi  -  入股协议
ba'wo'ji'yu  -  把握机遇
xin'dong'li  -  新动力
nan'hua'qi'huo  -  南华期货
mei'yuan'wei'ji  -  美元危机
zhe'zi'qian  -  折子钱
rui'fu'jin'qu  -  瑞福进取
xin'long'wu'fang  -  欣龙无纺
jin'rong'chuang'xin  -  金融创新
mei'ling'gu'fen  -  美菱股份
qing'shan'zhi'ye  -  青山纸业
chi'cang'bu'dong  -  持仓不动
san'tai'dian'zi  -  三泰电子
jin'shan'gong'ye  -  金山工业
qian'kai'di  -  黔凯涤
yang'guang'cheng  -  阳光城
zi'ben'yu'suan  -  资本预算
cai'wu'zhuang'kuang'biao  -  财务状况表
hua'lian'zong'chao  -  华联综超
bei'hai'yin'xing  -  北海银行
biao'shou  -  表首
mei'yan'shui'dian  -  梅雁水电
fu'kong  -  腹空
zhu'yao'cuo'shi  -  主要措施
du'bi  -  毒笔
yong'da'ji'tuan  -  永大集团
fu'jian'gong'shang'shi'bao  -  福建工商时报
ning'bo'yin'xing  -  宁波银行
dong'bei'cai'jing'da'xue  -  东北财经大学
huang'shan'jin'ma'gu'fen'you'xian'gong'si  -  黄山金马股份有限公司
shan'dong'de'mian'gu'fen'you'xian'gong'si  -  山东德棉股份有限公司
gui'lin'lv'you  -  桂林旅游
yun'nan'cheng'tou  -  云南城投
shan'xi'zhang'an  -  陕西长安
jing'wei'fang'ji  -  经纬纺机
heng'ji'da'xin  -  恒基达鑫
zhang'sheng'tong'zhi  -  长盛同智
jiao'yin'tian'li  -  交银添利
zhun'dai'ji'ka  -  准贷记卡
zhai'wu'wei'ji  -  债务危机
shi'mi'sen'xie'ding  -  史密森协定
mai'kong'zhe  -  卖空者
feng'huang'gu  -  凤凰股
hang'tian'ji'dian  -  航天机电
da'li'ji'tuan  -  达力集团
san'yi'zhong'gong  -  三一重工
shang'hai'jiu'bai  -  上海九百
ji'lin'hua'gong  -  吉林化工
zhang'hang'feng'huang  -  长航凤凰
zhu'li'zi'jin  -  主力资金
yi'qi'jin'bei  -  一汽金杯
long'ji'ji'xie  -  隆基机械
guang'zhou'leng'ji'gu'fen'you'xian'gong'si  -  广州冷机股份有限公司
huang'jin'wang  -  黄金网
shan'dong'mo'long  -  山东墨龙
ding'tai'xin'cai  -  鼎泰新材
jiang'su'fa'er'sheng'gu'fen'you'xian'gong'si  -  江苏法尔胜股份有限公司
zai'mai  -  再买
ruan'tong'huo  -  软通货
qing'dao'jian'ye  -  青岛碱业
dian'guang'shi'ye  -  电广实业
kan'zhang'zhe  -  看涨者
da'tong'man'ha'dun'yin'xing  -  大通曼哈顿银行
xing'ye'yin'xing  -  兴业银行
yi'min'hong'li  -  益民红利
wai'hui'jiao'yi  -  外汇交易
shen'zhen'sai'ge'gu'fen'you'xian'gong'si  -  深圳赛格股份有限公司
shang'hai'you'se'jin'shu'wang  -  上海有色金属网
ke'nuo'wei'de  -  科诺威德
shui'shou'wan'shui'zheng  -  税收完税证
zi'mai  -  自买
jiao'yi'zhi'nan  -  交易指南
hu'tai'fang'zhi  -  互太纺织
ruan'kong'gu'fen  -  软控股份
xiao'shou'dai'li'xie'yi  -  销售代理协议
nuo'an'ping'heng  -  诺安平衡
yi'qi'fu'wei  -  一汽富维
lei'ming'ke'hua  -  雷鸣科化
zhong'he'ke'ji  -  中核科技
ben'shi  -  本实
hong'fa'ji'tuan  -  红发集团
nan'tong'ke'ji  -  南通科技
gu'shi'kuai'xun  -  股市快讯
guo'ji'shi'ye  -  国际视野
chuang'xin'di  -  创新低
bi'ya'di'gu'fen  -  比亚迪股份
yi'qi'xia'li  -  一汽夏利
shi'jie'yin'xing  -  世界银行
zi'zhu'yin'xing  -  自助银行
shou'chuang'zhi'ye  -  首创置业
jian'guan'zheng'ce  -  监管政策
ping'zhi  -  平值
xie'fang'cha  -  协方差
zhu'jiang'shi'ye  -  珠江实业
mao'yi'tong  -  贸易通
hei'he'zi  -  黑盒子
he'bing'zi'chan'fu'zhai'biao  -  合并资产负债表
pan'huo'zi'chan  -  盘活资产
xin'yong'ping'ji  -  信用评级
yi'ben'tong  -  一本通
min'xin'ji'tuan  -  闽信集团
guo'tai'jin'peng  -  国泰金鹏
zhong'xin'zhuan'xiang  -  重新转向
xi'chang'dian  -  西昌电
shang'shi'gong'si  -  上市公司
chao'tu'ruan'jian  -  超图软件
gao'du'guan'zhu  -  高度关注
gu'quan'fen'zhi'gai'ge'fang'an  -  股权分置改革方案
gong'xin  -  工新
dong'fang'gao'ye  -  东方锆业
zhong'guo'bo'li  -  中国玻璃
zheng'zhou'ran'qi  -  郑州燃气
zheng'quan'dao'kan  -  证券导刊
dong'fang'bao'ye'ji'tuan  -  东方报业集团
fu'te'sai  -  福特赛
shan'dong'ru'yi  -  山东如意
zhong'guo'xiao'fang  -  中国消防
jin'long'ji'dian  -  金龙机电
fu'hua'ji'tuan  -  富华集团
pu'dong'jian'she  -  浦东建设
tian'yu'xin'xi  -  天喻信息
fa'xing'fang'an  -  发行方案
ling'shou  -  零手
xiao'gu'min  -  小股民
lu'shang'zhi'ye  -  鲁商置业
chuan'jin'lu  -  川金路
jia'shi'heng'sheng  -  嘉实恒生
tou'zi'zhe'jiao'yu  -  投资者教育
wei'chai'zhong'ji  -  潍柴重机
jin'li'ke'ji  -  金利科技
zhong'guo'fu'zhuang  -  中国服装
lv'jing'di'chan  -  绿景地产
qian'zhong'tian  -  黔中天
su'fu'ma  -  苏福马
cai'chan'an'quan  -  财产安全
kong'tou'huan'shou  -  空头换手
yun'nan'zhe'ye  -  云南锗业
zi'liu'e  -  自留额
zhong'xin'guo'an  -  中信国安
tian'fu're'dian  -  天富热电
shen'jin'xing  -  深锦兴
shan'xi'jin'ye  -  陕西金叶
la'gao'jun'jia  -  拉高均价
hua'bei'yin'xing  -  华北银行
shi'ji'gong'si  -  实际公司
an'tai'ke'ji'gu'fen'you'xian'gong'si  -  安泰科技股份有限公司
sai'ge'gu'fen  -  赛格股份
lei'bai'ke'ji  -  雷柏科技
jia'shui  -  价税
dian'hou  -  点后
gong'ji'jin'lv  -  公积金率
jiu'gu  -  旧股
san'xing'dian'qi  -  三星电气
dong'hua'ke'ji  -  东华科技
fei'ma'guo'ji  -  飞马国际
guang'dian'xin'xi  -  广电信息
yue'li'zhu  -  粤丽珠
gong'he'wang  -  共合网
kan'die'zhe  -  看跌者
hu'ke  -  沪科
hua'ren'yao'ye  -  华仁药业
hua'an'fu'li  -  华安富利
jin'rong'fu'wu  -  金融服务
zi'xun'gong'si  -  咨询公司
gu'e  -  固额
ci'dai'wei'ji  -  次贷危机
xin'tuo'zi'chan  -  信托资产
da'ya'ke'ji'gu'fen'you'xian'gong'si  -  大亚科技股份有限公司
xiao'huo'qing'dan  -  销货清单
hei'mu'dan  -  黑牡丹
dai'er'dian'nao  -  戴尔电脑
shou'guan'zhu  -  受关注
tian'ma'gu'fen  -  天马股份
zhong'chuang'xin'ce  -  中创信测
hua'fang'fang'zhi  -  华芳纺织
zhe'jia'lv  -  折价率
gong'yin'bao'ben  -  工银保本
wu'nian'qi'yi'shang  -  五年期以上
xin'hong'xin  -  新宏信
chi'ben'dan  -  持本单
tiao'dong'dian  -  跳动点
bai'yin'tong'cheng  -  白银铜城
guo'ji'shang'wu  -  国际商务
shou'hai  -  收还
yong'hui'chao'shi  -  永辉超市
gu'dong'da'hui'jue'yi  -  股东大会决议
pu'yin'hong'li  -  浦银红利
zhui'jia'bao'zheng'jin  -  追加保证金
zhong'hang'di'chan  -  中航地产
wu'kuang'qi'huo  -  五矿期货
xiang'mu'rong'zi  -  项目融资
jiao'yin'shi'luo'de  -  交银施罗德
kong'huan  -  空换
nei'meng'hong'feng  -  内蒙宏峰
mei'luo'yao'ye  -  美罗药业
feng'xian'tou'zi'shang  -  风险投资商
da'lai'ka  -  大莱卡
shen'nan'guang  -  深南光
zhong'yao'gong'gao  -  重要公告
na'shui'shen'bao  -  纳税申报
guo'fu'qiang'zhai  -  国富强债
zhi'ming'yin'xing  -  知名银行
shen'tian'di  -  深天地
dai'kuan'nan  -  贷款难
zhong'xi'yao'ye  -  中西药业
huang'jin'ji'tuan  -  黄金集团
guang'dong'guang'xin  -  广东广信
xin'long'tou  -  新龙头
tian'hong'shang'chang  -  天虹商场
fang'xing'di'chan  -  方兴地产
hai'nan'hai'yao  -  海南海药
qing'dao'hai'er  -  青岛海尔
dong'an'hei'bao  -  东安黑豹
duo'fu'duo  -  多氟多
guan'yin'bi  -  观音币
kai'nuo'ke'ji  -  凯诺科技
jin'zhou'shi'hua  -  锦州石化
ji'lin'tan'su  -  吉林炭素
xin'wu'feng  -  新五丰
wo'long'di'chan  -  卧龙地产
xu'gong'ke'ji  -  徐工科技
zhuo'er'fa'zhan  -  卓尔发展
tian'hong'feng'li  -  天弘丰利
hu'tong  -  沪铜
cai'zheng'yu'suan  -  财政预算
wai'gao  -  外高
guang'fa'hua'fu  -  广发华福
jian'yan'ji'tuan  -  建研集团
tian'yuan'ji'tuan  -  天原集团
chai'xi  -  拆细
lian'xin'yong'yi  -  联信永益
ce'lüe'yan'jiu  -  策略研究
zi'chan'gong'si  -  资产公司
hua'xia'tong  -  华夏通
jing'xin'tong'xin  -  京信通信
tian'zhi'shuang'ying  -  天治双盈
gu'han'ji'tuan  -  古汉集团
fu'guo'tian'cheng  -  富国天成
long'da  -  陇达
ning'bo'fu'bang  -  宁波富邦
fa'la'dian'zi  -  法拉电子
you'guan'gui'ding  -  有关规定
cai'hua'wang  -  财华网
a'bi'yin'xing  -  阿比银行
zhi'biao'gu  -  指标股
ning'tian'long  -  宁天龙
he'lan'wan'bei'yin'xing  -  荷兰万贝银行
liu'fu'ji'tuan  -  六福集团
bo'er'dian'li  -  博耳电力
cheng'zhang'xian'feng  -  成长先锋
jiao'yin'huan'qiu  -  交银环球
guo'dian'nan'zi  -  国电南自
jin'rong'tou'zi  -  金融投资
zhu'ce'hui'ji'shi  -  注册会计师
an'hui'sheng'wan'neng'gu'fen'you'xian'gong'si  -  安徽省皖能股份有限公司
jiang'su'jin'zhi'ke'ji'gu'fen'you'xian'gong'si  -  江苏金智科技股份有限公司
shi'lan'wei  -  士兰微
peng'bo'shi  -  鹏博士
guo'jiu'tiao  -  国九条
xin'zi'ben  -  新资本
lv'yue'lv  -  履约率
xin'yong'e'du  -  信用额度
he'er'tai  -  和而泰
shang'hai'zheng'quan  -  上海证券
zhong'guo'yi'liao  -  中国医疗
dong'fang'hui'li'yin'xing  -  东方汇理银行
ju'xing'ke'ji  -  巨星科技
mei'hua'san'ye'gu'fen'you'xian'gong'si  -  梅花伞业股份有限公司
zhong'guo'min'ying'jing'ji'zhou'kan  -  中国民营经济周刊
wa'fang'dian'zhou'cheng'gu'fen'you'xian'gong'si  -  瓦房店轴承股份有限公司
dong'tan  -  东碳
hua'yin'dian'li  -  华银电力
zi'ben'yun'zuo  -  资本运作
