jiao'che  -  轿车
er'shou'che  -  二手车
xin'che  -  新车
mo'tuo'che  -  摩托车
yong'che  -  用车
xiong'mao  -  熊猫
che'zhan  -  车展
mo'ju  -  模具
yi'biao  -  仪表
yi'qi  -  一汽
yao'kong  -  遥控
ling'bu'jian  -  零部件
quan'bao  -  全保
ao'di  -  奥迪
zhi'dong  -  制动
xing'guang  -  星光
ma'zi'da  -  马自达
qian'yin  -  牵引
niu'ju  -  扭矩
ba'dao  -  霸道
jia'you'zhan  -  加油站
ya'ge  -  雅阁
duo'pu'da  -  多普达
zhi'hui'guan  -  指挥官
shi'jia  -  试驾
jia'xiao  -  驾校
bi'ya'di  -  比亚迪
ling'mu  -  铃木
lei'nuo  -  雷诺
wu'wei  -  无畏
huan'ying  -  幻影
mo'he  -  磨合
yue'ye'che  -  越野车
feng'hua  -  风华
yue'jin  -  跃进
lin'ken  -  林肯
bei'jing'xian'dai  -  北京现代
xin'che'xing  -  新车型
le'feng  -  乐风
zhan'guan  -  展馆
you'pin  -  油品
dian'ping  -  电瓶
dong'feng'ri'chan  -  东风日产
duo'bao  -  多宝
jin'ying  -  金鹰
fei'die  -  飞碟
qi'che'ling'bu'jian  -  汽车零部件
tui'che  -  推车
zhong'guo'er'shou'che'cheng  -  中国二手车城
meng'di'ou  -  蒙迪欧
xi'huo  -  熄火
qian'bao  -  前保
pai'fang'biao'zhun  -  排放标准
ye'ma  -  野马
si'ke'da  -  斯柯达
ru'hu  -  如虎
wei'deng  -  尾灯
nuo'ya  -  诺亚
pai'fang'liang  -  排放量
le'cheng  -  乐骋
si'ba'lu  -  斯巴鲁
xin'kai  -  新凯
jin'niu'zuo  -  金牛座
lie'bao  -  猎豹
zhong'gao'ji'che  -  中高级车
zi'dong'dang  -  自动挡
zi'dong'bian'su'xiang  -  自动变速箱
xi'niu  -  犀牛
xin'kai'yue  -  新凯越
tuo'che  -  拖车
ou'lu  -  欧陆
ji'cheng'che  -  计程车
qi'che'jia'ge  -  汽车价格
dang'feng'bo'li  -  挡风玻璃
ao'ke'si  -  奥克斯
ou'ge  -  讴歌
ao'de'sai  -  奥德赛
tan'xian'wei  -  碳纤维
dong'feng'yue'da  -  东风悦达
dong'feng'ben'tian  -  东风本田
zhan'fu  -  战斧
dong'feng'yue'da'qi'ya  -  东风悦达起亚
tiao'zhan'zhe  -  挑战者
pin'pai'qi'che  -  品牌汽车
ao'ding  -  奥丁
jia'hua  -  嘉华
biao'qiang  -  标枪
gao'dang'jiao'che  -  高档轿车
tian'jin'yi'qi  -  天津一汽
qian'jin'ding  -  千斤顶
mei'sai'de'si  -  梅赛德斯
qiang'yin  -  强音
shou'dong'bian'su'xiang  -  手动变速箱
zhen'kong'beng  -  真空泵
ou'bao  -  欧宝
ling'zhi  -  凌志
yi'da  -  颐达
xiao'deng  -  小灯
dai'mu'lei  -  戴姆勒
qi'che'xiao'shou'fu'wu  -  汽车销售服务
qi'che'mao'yi  -  汽车贸易
yi'qi'ma'zi'da  -  一汽马自达
xiu'xian'che  -  休闲车
bei'dong'an'quan  -  被动安全
gai'ban  -  盖板
xiao'ke  -  逍客
yi'qi'jiao'che  -  一汽轿车
yi'biao'tai  -  仪表台
xiao'pai'liang'qi'che  -  小排量汽车
ku'lu'ze  -  酷路泽
lao'ye'che  -  老爷车
qi'che'ju'le'bu  -  汽车俱乐部
tui'bu'kong'jian  -  腿部空间
xiao'zi  -  肖子
yuan'dong'li  -  源动力
re'ban  -  热板
wan'che  -  玩车
jin'qi'ge'zha  -  进气格栅
mao'ding  -  铆钉
gong'wei  -  工位
fa'dong'ji'zhuan'su  -  发动机转速
shuai'wei  -  甩尾
ying'fei'ni'di  -  英菲尼迪
gu'feng'ji  -  鼓风机
qi'che'xiao'shou'fu'wu'you'xian'gong'si  -  汽车销售服务有限公司
bu'fen'che'xing  -  部分车型
gai'kuan'che  -  改款车
gong'lu'ke'yun  -  公路客运
da'zhong'zhong'guo  -  大众中国
tou'bu'kong'jian  -  头部空间
sha'zhi  -  砂纸
de'er'fu  -  德尔福
xin'ai'li'she  -  新爱丽舍
quan'qiu'ding'wei'xi'tong  -  全球定位系统
qi'che'ying'xiao  -  汽车营销
nian'du'che  -  年度车
song'ge  -  颂歌
yuan'jian  -  远舰
shan'di'che  -  山地车
hua'xia'er'shou'che  -  华夏二手车
li'ou  -  利欧
du'xin'ban  -  镀锌板
an'yuan  -  安源
fang'bao'mo  -  防爆膜
tuo'jia  -  托架
wei'xiu'chang  -  维修厂
ling'hang'yuan  -  领航员
da'bao'wei  -  大包围
yi'gui  -  乙炔
qian'wei  -  前围
lian'xi'qu  -  练习曲
jia'xiao'yi'dian'tong  -  驾校一点通
tao'dun  -  逃遁
zhi'dong'ye  -  制动液
zhi'hui'fa  -  止回阀
che'zhan'qi'jian  -  车展期间
dao'mo  -  倒模
feng'dang'bo'li  -  风挡玻璃
jia'ma  -  伽马
lun'ding'wei  -  轮定位
dian'jie'ye  -  电解液
dong'li'zhuan'xiang  -  动力转向
lun'ju  -  轮距
zhen'kong'guan  -  真空管
lu'di'xun'yang'jian  -  陆地巡洋舰
zhi'xiang  -  志翔
bie'ke'kai'yue  -  别克凯越
qian'dang'feng'bo'li  -  前挡风玻璃
heng'wen'kong'diao  -  恒温空调
zhi'chi'huan  -  支持环
mo'pian  -  膜片
qi'che'mao'yi'you'xian'gong'si  -  汽车贸易有限公司
ying'ji'deng  -  应急灯
ye'jie'dong'tai  -  业界动态
zhe'jiang'qi'che'wang  -  浙江汽车网
xin'neng'yuan'che  -  新能源车
ce'shi'ji  -  测试机
shou'dong'hao'hua  -  手动豪华
bu'jia'di  -  布加迪
qian'yin'li'kong'zhi'xi'tong  -  牵引力控制系统
zhang'an'ma'zi'da  -  长安马自达
chang'he'ling'mu  -  昌河铃木
wei'zhang'cha'xun  -  违章查询
zhong'hua'jun'jie  -  中华骏捷
qian'feng'dang  -  前风挡
xia'hu  -  下护
gao'wei'sha'che  -  高位刹车
si'lun'ding'wei  -  四轮定位
gao'wei'sha'che'deng  -  高位刹车灯
lian'jie'guan  -  连接管
da'lu  -  达路
wen'du'chuan'gan'qi  -  温度传感器
che'zai'dian'hua  -  车载电话
jia'xin'guang  -  贾新光
shang'hai'da'zhong'si'ke'da  -  上海大众斯柯达
zi'dong'hao'hua  -  自动豪华
da'qie'nuo'ji  -  大切诺基
mo'tuo'che'pei'jian  -  摩托车配件
zhi'nan'zhe  -  指南者
tong'yong'bie'ke  -  通用别克
bei'qi'kong'gu  -  北汽控股
jie'di'xian  -  接地线
leng'mei  -  冷媒
yuan'guang'deng  -  远光灯
wu'yao'shi  -  无钥匙
qian'ge'zha  -  前格栅
zhi'lie'si'gang  -  直列四缸
lu'su'deng  -  卤素灯
zhi'jin'he  -  纸巾盒
jiao'che'hua  -  轿车化
yao'kong'yao'shi  -  遥控钥匙
xi'ye'na  -  西耶那
zhong'guo'qi'che'ji'shu'yan'jiu'zhong'xin  -  中国汽车技术研究中心
si'gang'fa'dong'ji  -  四缸发动机
lun'mei  -  轮眉
mei'you'xian'che  -  没有现车
zhong'guo'qi'che'wang  -  中国汽车网
kong'qi'qing'xin'ji  -  空气清新剂
ye'wei'ji  -  液位计
zhuang'shi'deng  -  装饰灯
suo'xin  -  锁芯
qian'hou'bao'xian'gang  -  前后保险杠
nei'hou'shi'jing  -  内后视镜
ce'wei  -  侧围
lu'kuang'xia  -  路况下
zhong'di'yin  -  中低音
meng'di'ou'zhi'sheng  -  蒙迪欧致胜
wei'xian'huo'wu'yun'shu  -  危险货物运输
qi'jun  -  奇骏
luo'mao  -  螺帽
lu'feng'qi'che  -  陆风汽车
xin'jia'le  -  新佳乐
fang'xuan'mu  -  防眩目
qian'zhao'deng  -  前照灯
bei'dong'an'quan'xing  -  被动安全性
zhuan'wan'ban'jing  -  转弯半径
pin'pai'er'shou'che  -  品牌二手车
gao'su'guo'wan  -  高速过弯
ba'li'che'zhan  -  巴黎车展
jia'shi'yuan'zuo'yi  -  驾驶员座椅
sui'dong'zhuan'xiang  -  随动转向
zhou'mo'feng  -  周末风
mei'gan'na  -  梅甘娜
dian'pen'fa'dong'ji  -  电喷发动机
sheng'chan'gong'yi'ji'shu  -  生产工艺技术
pai'xi  -  派喜
luan'chuan'ma'lu  -  乱穿马路
che'zai'bing'xiang  -  车载冰箱
dian'zi'zhi'dong'li'fen'pei'xi'tong  -  电子制动力分配系统
pu'li'mao'si  -  普利茅斯
ge're'cai'liao  -  隔热材料
zuo'yi'kao'bei  -  座椅靠背
yi'lan'te'yue'dong  -  伊兰特悦动
hou'feng'dang  -  后风挡
shang'hai'tong'yong'bie'ke  -  上海通用别克
que'xian'chan'pin  -  缺陷产品
dian'huo'xian'quan  -  点火线圈
fang'tao'mu  -  仿桃木
qing'zhang'che  -  清障车
niu'tui  -  牛腿
shou'dong'kong'diao  -  手动空调
si'lun'die'sha  -  四轮碟刹
zhong'gai  -  中盖
qian'kuai  -  铅块
zui'xiao'li'di'jian'xi  -  最小离地间隙
yi'qi'ao'di  -  一汽奥迪
feng'jun  -  风骏
quan'qiu'ying  -  全球鹰
yuan'jing  -  圆镜
xiao'pai'liang'jiao'che  -  小排量轿车
ran'shao'guo'cheng  -  燃烧过程
ya'xing'ke'che  -  亚星客车
jiang'nan'ao'ta  -  江南奥拓
zhang'feng'lie'bao  -  长丰猎豹
che'zai'dian'nao  -  车载电脑
bao'xian'gan  -  保险杆
zhong'guo'qi'che'gong'cheng'xue'hui  -  中国汽车工程学会
gang'nei'zhi'pen  -  缸内直喷
jin'cou'che'xing  -  紧凑车型
biao'zhi'deng'ju  -  标志灯具
zhi'jie'qu'dong  -  直接驱动
zhang'cheng'ha'fu  -  长城哈弗
sai'la'tu'ou'feng  -  赛拉图欧风
lv'xing'jiao'che  -  旅行轿车
zuo'yi'jia're  -  座椅加热
di'yi'qi'che'ji'tuan'gong'si  -  第一汽车集团公司
qian'feng'dang'bo'li  -  前风挡玻璃
liang'qian  -  两前
xin'jia'nian'hua  -  新嘉年华
lu'feng'feng'hua  -  陆风风华
san'jiao'dai  -  三角带
zhuan'zi'fa'dong'ji  -  转子发动机
xin'ao'de'sai  -  新奥德赛
qi'che'xiao'fei'xin'dai  -  汽车消费信贷
dian'han'tiao  -  电焊条
jing'ying'chu  -  经营处
fu'chou'nv'shen  -  复仇女神
shou'la'hu'lu  -  手拉葫芦
ou'fei'lai'si  -  欧菲莱斯
xing'ye'fa'gui  -  行业法规
zhi'dong'deng  -  制动灯
bei'jing'guo'ji'qi'che'zhan'lan'hui  -  北京国际汽车展览会
hou'dang'feng'bo'li  -  后挡风玻璃
lu'ba  -  陆霸
pai'dang'gan  -  排挡杆
qi'che'ying'yin  -  汽车影音
zu'he'biao  -  组合表
shuang'mian'jiao'dai  -  双面胶带
xin'da'di  -  新大地
qi'che'ling'bu'jian'you'xian'gong'si  -  汽车零部件有限公司
yu'jin'shi'an'quan'dai  -  预紧式安全带
che'men'ba'shou  -  车门把手
feng'fa  -  风阀
ying'ge'er  -  英格尔
ge're'ban  -  隔热板
fen'dong'xiang  -  分动箱
shui'wen'biao  -  水温表
shi'jia'hou  -  试驾后
lan'de'ku'lu'ze  -  兰德酷路泽
heng'wen'kong'zhi  -  恒温控制
di'niu  -  低扭
jian'cha'fa'dong'ji  -  检查发动机
xing'xing'chi'lun  -  行星齿轮
he'ye  -  合叶
hua'chen'zhong'hua  -  华晨中华
te'hei  -  特黑
lu'di  -  路帝
jiao'che'fa'dong'ji  -  轿车发动机
yin'du'si'tan  -  印度斯坦
che'ti'jie'gou  -  车体结构
qi'che'wei'xiu'ji'shu  -  汽车维修技术
li'qu'jiao  -  离去角
lan'pai'che  -  蓝牌车
lao'che'zhu  -  老车主
lun'jian  -  轮间
zhu'hai'guo'ji'sai'che'chang  -  珠海国际赛车场
zhong'da'qi'che  -  中大汽车
jia'shi'yuan'ce  -  驾驶员侧
yuan'zhui'gun'zi'zhou'cheng  -  圆锥滚子轴承
dian'dong'bo'li  -  电动玻璃
che'zai'dian'tai  -  车载电台
kong'diao'lv'xin  -  空调滤芯
dong'feng'kang'ming'si  -  东风康明斯
ao'long  -  翱龙
jiang'ling'lu'feng  -  江铃陆风
che'zai'dao'hang'xi'tong  -  车载导航系统
zheng'che'ji'ling'bu'jian  -  整车及零部件
ma'lai'xi'ya'da'jiang'sai  -  马来西亚大奖赛
qian'yi'zi'ban  -  前翼子板
chao'ji'wei'te'la  -  超级维特拉
a'si'dun'ma'ding  -  阿斯顿马丁
dong'feng'xiao'kang  -  东风小康
shi'cheng'shi'jia'che  -  试乘试驾车
zhi'dong'qian  -  制动钳
che'men'bo'li  -  车门玻璃
lie'bao'fei'teng  -  猎豹飞腾
lei'nuo'fang'cheng'shi  -  雷诺方程式
da'xing'che'zhan  -  大型车展
ye'zi'ban  -  叶子板
nei'shi'cai'liao  -  内饰材料
he'cheng'ji'you  -  合成机油
hou'feng'chuang  -  后风窗
biao'de'che  -  标的车
fei'xing'jia  -  飞行家
niu'bo'ge'lin  -  纽博格林
feng'fan  -  锋范
ce'zhuan'xiang'deng  -  侧转向灯
gong'neng'guan'bi  -  功能关闭
fei'cheng'zai'shi'che'shen  -  非承载式车身
gai'che'zhu  -  该车主
fang'xuan'mu'hou'shi'jing  -  防眩目后视镜
dai'mu'lei'ke'lai'si'lei  -  戴姆勒克莱斯勒
yi'xi'huo  -  易熄火
dao'qi'kai'ling  -  道奇凯领
feng'tian'lu'di'xun'yang'jian  -  丰田陆地巡洋舰
qi'che'dang'feng'bo'li  -  汽车挡风玻璃
tu'yuan  -  凸缘
huo'gen'hai'mu'sai'dao  -  霍根海姆赛道
si'lun'ding'wei'yi  -  四轮定位仪
xing'fu'shi'zhe  -  幸福使者
kang'mo'ji  -  抗磨剂
zhang'cheng'jiao'che  -  长城轿车
che'nei'hou'shi'jing  -  车内后视镜
dian'yuan'zhuan'huan'qi  -  电源转换器
qi'che'yao'kong  -  汽车遥控
hou'zhi'dong  -  后制动
ye'pian'beng  -  叶片泵
xia'hu'ban  -  下护板
ke'lai'si'lei'da'jie'long  -  克莱斯勒大捷龙
qi'che'fu'gai'jian  -  汽车覆盖件
jiang'ling'ji'tuan  -  江铃集团
qi'che'pao'mao  -  汽车抛锚
shui'sha'zhi  -  水砂纸
ri'chan'xiao'ke  -  日产逍客
qian'zhi'fa'dong'ji  -  前置发动机
wu'yao'shi'qi'dong  -  无钥匙启动
hou'feng'dang'bo'li  -  后风挡玻璃
sui'che'gong'ju  -  随车工具
wei'xian'bao'jing'shan'guang'deng  -  危险报警闪光灯
shang'hai'da'zhong'si'ke'da'ming'rui  -  上海大众斯柯达明锐
qian'zhi'dong  -  前制动
qian'pai'ce'qi'nang  -  前排侧气囊
bi'bi'deng  -  必比登
qiao'dan'che'dui  -  乔丹车队
bao'wen'ge're'cai'liao  -  保温隔热材料
shang'zhi'dian  -  上止点
dian'huo'yao'shi  -  点火钥匙
tuo'ye'bi'shi  -  拖曳臂式
bu'xiu'gang'fa  -  不锈钢阀
she'fu'lei'ji'tuan  -  舍弗勒集团
dang'quan  -  挡圈
zheng'zhou'ri'chan'pa'la'ding  -  郑州日产帕拉丁
fu'te'fu'ke'si'liang'xiang  -  福特福克斯两厢
dian'lu'duan'lu  -  电路短路
shou'fang'ji  -  收放机
yao'chuang  -  摇窗
biao'mian'que'xian  -  表面缺陷
lin'ken'ling'hang'yuan  -  林肯领航员
ying'yin'wang  -  影音网
gu'bo  -  固铂
fen'pin'dian  -  分频点
shuang'li'he'bian'su'qi  -  双离合变速器
gang'bei  -  钢背
ao'ke'si'qi'che  -  奥克斯汽车
qing'jie'neng'yuan'qi'che  -  清洁能源汽车
ji'li'xiong'mao  -  吉利熊猫
yang'mao'qiu  -  羊毛球
si'chuan'feng'tian  -  四川丰田
qi'che'dian'zi'dian'qi  -  汽车电子电器
xing'che'deng  -  行车灯
ba'lin'da'jiang'sai  -  巴林大奖赛
lai'zhan'ting  -  来展厅
a'er'fa'luo'mi'ou  -  阿尔法罗密欧
gao'wei'zhi'dong'deng  -  高位制动灯
chi'ye  -  驰野
wen'kong'kai'guan  -  温控开关
shui'wen'chuan'gan'qi  -  水温传感器
dao'gou'zhuan'ti  -  导购专题
a'er'bo'te'gong'yuan'sai'dao  -  阿尔伯特公园赛道
qian'tiao  -  嵌条
qing'zhuan  -  青专
zhe'jiang'ji'li'kong'gu'ji'tuan  -  浙江吉利控股集团
yi'biao'deng  -  仪表灯
zhang'an'fu'te'fu'ke'si  -  长安福特福克斯
dian'qi'yi'biao  -  电器仪表
shou'ci'bao'yang  -  首次保养
qiao'chang  -  桥厂
lin'ken'jiao'che  -  林肯轿车
kong'qiang'zhu'la  -  空腔注蜡
shi'gai  -  室盖
gai'jin'ji  -  改进剂
ling'lu'sai'dao  -  铃鹿赛道
fa'dong'ji'kong'zhi'dan'yuan  -  发动机控制单元
sang'ta'na'zhi'jun  -  桑塔纳志俊
qi'che'pai'fang'biao'zhun  -  汽车排放标准
bin'li'ou'lu  -  宾利欧陆
hu'bei'qi'che'gong'ye'xue'yuan  -  湖北汽车工业学院
mu'tan'qi'che  -  木炭汽车
mi'qi'lin'ji'tuan  -  米其林集团
huan'fang'dong'ye  -  换防冻液
gu'jia'you'feng  -  骨架油封
shi'kuang  -  饰框
zhang'an'zhi'xiang  -  长安志翔
shi'gai  -  饰盖
dian'dong'zhu'li'zhuan'xiang'xi'tong  -  电动助力转向系统
zong'bi'niu'zhuan  -  纵臂扭转
qi'pei'gong'si  -  汽配公司
dou'po'huan'jiang  -  陡坡缓降
wu'ling'rong'guang  -  五菱荣光
pai'zhao'ban  -  牌照板
qian'lun'ding'wei  -  前轮定位
zhang'cheng'jia'yu  -  长城嘉誉
mo'lei  -  摩雷
an'quan'kai'guan  -  安全开关
lv'xing'fang'che  -  旅行房车
pai'zhao'kuang  -  牌照框
xiao'xing'cheng'yong'che  -  小型乘用车
ce'chuang'bo'li  -  侧窗玻璃
you'ka'er'shou'che'wang  -  优卡二手车网
ling'mu'bei'dou'xing  -  铃木北斗星
wu'yao'shi'qi'dong'xi'tong  -  无钥匙启动系统
zhuan'su'chuan'gan'qi  -  转速传感器
niu'bo'ge'lin'sai'dao  -  纽博格林赛道
quan'shi'shu'zi'jiao'che  -  全时数字轿车
zi'xie'huo'che  -  自卸货车
zhuan'xiang'ye  -  转向液
cong'dong'lun  -  从动轮
lu'ying'che  -  露营车
qiang'zhi'tong'feng  -  强制通风
xia'ge'zha  -  下格栅
lei'nuo'mei'gan'na  -  雷诺梅甘娜
chu'ye'guan  -  储液罐
jia'ke'chong'qi'che  -  甲壳虫汽车
xia'bai'bi  -  下摆臂
si'chong'cheng'fa'dong'ji  -  四冲程发动机
fei'fa'gai'zhuang'che  -  非法改装车
wo'shi'jia  -  我试驾
zi'gong'luo'ding  -  自攻螺钉
xin'pian'yao'shi  -  芯片钥匙
qi'you'zhi'pen'ji'shu  -  汽油直喷技术
an'quan'dai'ti'xing'zhuang'zhi  -  安全带提醒装置
xin'fu'te'jia'nian'hua  -  新福特嘉年华
ying'guo'qi'che'gong'ye  -  英国汽车工业
hun'he'dong'li'dian'dong'qi'che  -  混合动力电动汽车
pang'di'ya'ke  -  庞蒂亚克
che'liang'wen'ding'xing'kong'zhi'xi'tong  -  车辆稳定性控制系统
qian'bao'xian'gan  -  前保险杆
dian'ci'huan'xiang'fa  -  电磁换向阀
zhong'qing'guo'ji'che'zhan  -  重庆国际车展
wei'bao'an  -  未报案
qi'che'wei'xiu'she'bei  -  汽车维修设备
bei'qi'kong'gu'gong'si  -  北汽控股公司
nong'yong'qi'che  -  农用汽车
che'mi'pin'dao  -  车迷频道
hou'zhi'fa'dong'ji  -  后置发动机
pu'rui'wei'ya  -  普瑞维亚
bian'niu'qi  -  变扭器
yi'qi'wei'zhi  -  一汽威志
yan'hui'he  -  烟灰盒
ge'lan'pi'zhi'da'sai  -  格兰披治大赛
ya'ke'shi  -  雅科仕
kai'li'de'di'tu  -  凯立德地图
leng'dong'ji  -  冷冻剂
dian'zi'dian'kong  -  电子电控
zhi'neng'yao'shi'xi'tong  -  智能钥匙系统
kang'mo'ye'ya'you  -  抗磨液压油
qu'zhou'wei'zhi  -  曲轴位置
xi'yuan'xiao'qu  -  西苑小区
zhuan'xiang'zuo'ye'che  -  专项作业车
che'men'fu'shou  -  车门扶手
lin'ken'cheng'shi  -  林肯城市
tian'ma'ying'xiong  -  天马英雄
kong'diao'beng  -  空调泵
ri'chan'qi'jun  -  日产奇骏
fei'die'qi'che  -  飞碟汽车
duo'xie'dai  -  多楔带
chen'guang'zu  -  陈光祖
bie'ke'kai'yue'lv'xing'che  -  别克凯越旅行车
mi'na'er'di'che'dui  -  米纳尔迪车队
qian'dang'mo  -  前挡膜
ri'chan'ni'sang  -  日产尼桑
wu'gai'jia'you'xi'tong  -  无盖加油系统
dong'feng'yu'an  -  东风渝安
ji'li'you'li'ou  -  吉利优利欧
dian'dong'bo'li'sheng'jiang'qi  -  电动玻璃升降器
quan'che'ge'yin  -  全车隔音
da'lu'qi'che'ju'le'bu  -  大陆汽车俱乐部
kong'diao'guan'lu  -  空调管路
hou'yi'zi'ban  -  后翼子板
qian'yue'du'deng  -  前阅读灯
dao'qi'gong'yang  -  道奇公羊
gao'pin'zhi'yin'xiang  -  高品质音响
xing'che'zhi'dong  -  行车制动
heng'hua  -  横滑
ji'lv'xin  -  机滤芯
bian'su'qi'jie'gou'yuan'li  -  变速器结构原理
ying'te'la'ge'si'sai'dao  -  英特拉格斯赛道
hou'bao'xian'gan  -  后保险杆
qi'che'kong'diao'ya'suo'ji  -  汽车空调压缩机
che'men'kuang  -  车门框
zi'dong'bian'su'xiang'you  -  自动变速箱油
zhi'lie'fa'dong'ji  -  直列发动机
hua'xiang'fu'qi  -  华翔富奇
ri'chang'wei'hu'fei  -  日常维护费
ao'di'qi'che'gong'si  -  奥迪汽车公司
zhi'dong'guan'lu  -  制动管路
niu'li'gan  -  扭力杆
fa'dong'ji'xia'hu'ban  -  发动机下护板
qian'feng'chuang  -  前风窗
ji'zhuan  -  激转
jin'gang'guo'ji'sai'che'chang  -  金港国际赛车场
wei'lun'niu'fu'sai'dao  -  维伦纽夫赛道
yao'kong'shou'bing  -  遥控手柄
de'guo'da'zhong'qi'che'ji'tuan  -  德国大众汽车集团
dian'yuan'suo  -  电源锁
ceng'jiao  -  层焦
qian'fen'biao  -  千分表
kong'qi'qing'jing'ji  -  空气清净机
fa'dong'ji'fang'dao'suo'zhi'xi'tong  -  发动机防盗锁止系统
zi'dong'pai'dang  -  自动排挡
qi'ya'ba'rui  -  起亚霸锐
da'deng'gao'du'ke'diao  -  大灯高度可调
dong'feng'yue'da'qi'ya'shi'pao  -  东风悦达起亚狮跑
huo'shao'che  -  火烧车
qu'zhou'wei'zhi'chuan'gan'qi  -  曲轴位置传感器
lun'tai'huan'wei  -  轮胎换位
jiao'tong'an'quan'chan'pin  -  交通安全产品
fen'dian'ji  -  分电机
feng'han  -  风焊
cai'gua'bu  -  菜瓜布
qi'che'gua'jian  -  汽车挂件
di'yi'xiang'you  -  第一箱油
qi'che'ji'shu'fu'wu'yu'ying'xiao  -  汽车技术服务与营销
ri'quan'shi  -  日全蚀
qi'men'dan'huang  -  气门弹簧
ji'pu'da'qie'nuo'ji  -  吉普大切诺基
nei'bu'duan'lu  -  内部短路
shou'pai'dang  -  手排挡
fei'chang'cheng'shi  -  非常城市
bo'li'qing'xi'ye  -  玻璃清洗液
bi'ya'di'ji'tuan  -  比亚迪集团
zui'da'pa'po'du  -  最大爬坡度
dian'yuan'zong'kai'guan  -  电源总开关
gai'dian  -  盖垫
qi'che'zhi'dong'ye  -  汽车制动液
qi'che'can'zhi  -  汽车残值
shuang'long'zhu'xi  -  双龙主席
da'mao'shou'xu  -  大贸手续
bao'wen'lu  -  保温炉
ding'sun'ren'yuan  -  定损人员
wei'hong'jie  -  魏红杰
zhang'jin'lun  -  涨紧轮
kao'wei'te  -  考维特
che'zai'zi'dong'zhen'duan'xi'tong  -  车载自动诊断系统
jie'gou'wan'zheng'xing  -  结构完整性
sha'men'jin'long'qi'che  -  厦门金龙汽车
zhi'dong'fen'beng  -  制动分泵
dian'ci'kai'guan  -  电磁开关
san'yuan'cui'hua'zhuan'huan'qi  -  三元催化转换器
an'quan'dai'gu'ding  -  安全带固定
er'shou'che'jian'ding'ping'gu'shi  -  二手车鉴定评估师
dian'dong'zhuan'xiang  -  电动转向
mo'sha'hei  -  磨砂黑
mao'pu'qi'che  -  猫扑汽车
ming'che'zhi  -  名车志
de'guo'xi'li'shi  -  德国喜力士
si'ke'da'ou'ya  -  斯柯达欧雅
mang'dian'xin'xi'xi'tong  -  盲点信息系统
dan'huang'dian'quan  -  弹簧垫圈
ben'chi'che'dui  -  奔驰车队
yi'qi'feng'yue  -  一汽丰越
er'tong'cheng'che'an'quan  -  儿童乘车安全
nan'jing'yue'jin  -  南京跃进
zhi'dong'mo'ca'pian  -  制动摩擦片
cheng'shi'jing'ling  -  城市精灵
che'nei'zhong'kong'suo  -  车内中控锁
fa'dong'ji'lou'you  -  发动机漏油
xian'dai'wang  -  现代王
feng'tian'xi'yi'lang  -  丰田喜一郎
ling'mu'ji'mu'ni  -  铃木吉姆尼
yu'gua'dian'ji  -  雨刮电机
sui'dong'zhuan'xiang'da'deng  -  随动转向大灯
dian'zi'feng'shan  -  电子风扇
shang'hai'tong'yong'kai'di'la'ke  -  上海通用凯迪拉克
xian'dai'yue'dong  -  现代悦动
fei'ya'te'xi'ye'na  -  菲亚特西耶那
ying'pai'yue'ye'che  -  硬派越野车
hou'lun'sui'dong'zhuan'xiang'ji'shu  -  后轮随动转向技术
sha'mo'yue'ye'che  -  沙漠越野车
fu'yi'biao  -  副仪表
guang'qi'ri'ye  -  广汽日野
ya'suo'xing'cheng  -  压缩行程
si'chuang  -  四窗
yi'xing'gang'guan  -  异形钢管
hou'lun'mei  -  后轮眉
qi'che'xin'pian  -  汽车芯片
guo'ji'jia'shi'zhi'zhao  -  国际驾驶执照
shui'jing'xiang'shui'ping  -  水晶香水瓶
pang'di'ke  -  旁蒂克
fei'ya'te'xiong'mao  -  菲亚特熊猫
nuan'tai'quan  -  暖胎圈
ri'nei'wa'guo'ji'qi'che'zhan  -  日内瓦国际汽车展
ma'zi'da'pu'li'ma  -  马自达普力马
si'gang'ji  -  四缸机
che'zai'dui'jiang'ji  -  车载对讲机
fen'dian'qi'gai  -  分电器盖
fei'lun'ke  -  飞轮壳
liang'qian'lun  -  两前轮
pai'li'ao'zhou'mo'feng  -  派力奥周末风
xian'dai'wei'la'ke'si  -  现代维拉克斯
qian'wei'ban  -  前围板
sha'mo'zhi'hu  -  沙漠之虎
tuo'zhuai'bi  -  拖拽臂
dian'gong'jiao'dai  -  电工胶带
xian'dai'xin'sheng'da  -  现代新胜达
niu'ju'ban'shou  -  扭矩扳手
fu'te'meng'di'ou'zhi'sheng  -  福特蒙迪欧致胜
yao'shi'kai'guan  -  钥匙开关
zhao'gong'kou'zhang'tu'qi'che'zhan  -  赵公口长途汽车站
fu'jian'dai'mu'lei  -  福建戴姆勒
gan'zai'bi'li'fa  -  感载比例阀
zi'xie'fan'dou'che  -  自卸翻斗车
zhi'la'gan  -  直拉杆
qian'zuo'zhong'yang'fu'shou  -  前座中央扶手
zhu'dong'shi'an'quan'tou'zhen  -  主动式安全头枕
wei'zhi'deng  -  位置灯
ao'men'ge'lan'pi'zhi'da'sai'che  -  澳门格兰披治大赛车
chang'he'ling'mu'li'ya'na  -  昌河铃木利亚纳
you'feng'lou'you  -  油封漏油
fa'lei'ao'ji'tuan  -  法雷奥集团
si'ba'lu'zhong'guo'la'li'che'dui  -  斯巴鲁中国拉力车队
bei'ji'xing'fa'dong'ji  -  北极星发动机
ji'pu'zhi'hui'guan  -  吉普指挥官
yi'qi'jie'fang'qi'che'you'xian'gong'si  -  一汽解放汽车有限公司
qian'ye'zi'ban  -  前叶子板
fen'huo'tou  -  分火头
yao'bi'zhou  -  摇臂轴
xiao'pi'liang'chan'pin  -  小批量产品
dian'huo'mo'kuai  -  点火模块
lou'fang'dong'ye  -  漏防冻液
jin'lv'ke'che  -  金旅客车
tuo'ye'bi'shi'xuan'jia  -  拖曳臂式悬架
duan'yuan'zhu'gun'zi'zhou'cheng  -  短圆柱滚子轴承
bu'hui'wei  -  不回位
you'fu'shou  -  右扶手
fang'hua'di'ban  -  防滑地板
qi'che'chan'ye'yan'jiu  -  汽车产业研究
quan'cheng'zai'che'shen  -  全承载车身
hou'lun'gu  -  后轮鼓
wei'ya'nuo  -  唯雅诺
tao'mu'shi'jian  -  桃木饰件
tong'feng'fa  -  通风阀
ping'zhi'fang'che  -  平治房车
dou'shi'cai'hong  -  都市彩虹
dong'feng'han'ma  -  东风汗马
dong'feng'yue'ye  -  东风越野
wo'ke'si'hao'er  -  沃克斯豪尔
qian'lun'mei  -  前轮眉
chi'lun'chi'tiao'shi'zhuan'xiang  -  齿轮齿条式转向
deng'lu'pu'lun'tai  -  邓禄普轮胎
gua'bi  -  刮臂
lei'mang'nai'li'sai  -  勒芒耐力赛
dian'zi'zhu'che'zhi'dong'xi'tong  -  电子驻车制动系统
da'deng'kai'guan  -  大灯开关
qian'men'bo'li  -  前门玻璃
jiao'deng  -  脚瞪
li'he'qi'mo'ca'pian  -  离合器摩擦片
qu'zhou'mo'chuang  -  曲轴磨床
sha'mo'che  -  沙漠车
hong'se'qiang'wei  -  红色蔷薇
quan'pin'la'ba  -  全频喇叭
kuang'yong'zi'xie'che  -  矿用自卸车
cha'bei'jia  -  茶杯架
mei'lu  -  美鹿
guo'ji'chuang'mo'xie'hui  -  国际窗膜协会
qian'zhuan'xiang'deng  -  前转向灯
qi'che'qian'yin  -  汽车牵引
qi'nang'deng  -  气囊灯
huan'chong'jiao  -  缓冲胶
zhi'hui'dai'kuan  -  智慧贷款
shi'gu'wei'xiu  -  事故维修
yuan'zhu'xiao  -  圆柱销
leng'che'qi'dong  -  冷车起动
xin'le'feng  -  新乐风
kong'diao'lv'wang  -  空调滤网
wei'qi'fen'xi'yi  -  尾气分析仪
bei'jing'ben'chi'dai'ke  -  北京奔驰戴克
geng'huan'dian'ping  -  更换电瓶
yu'gua'bi  -  雨刮臂
qiao'ban'kai'guan  -  翘板开关
jin'kou'si'ke'da  -  进口斯柯达
di'pan'ge'yin  -  底盘隔音
bie'ke'gao'er'fu'tiao'zhan'sai  -  别克高尔夫挑战赛
gang'guan'che  -  钢管车
wo'er'wo'ke'che  -  沃尔沃客车
dong'li'zhuan'xiang'beng  -  动力转向泵
cong'dong'pan'zong'cheng  -  从动盘总成
shang'bai'bi  -  上摆臂
quan'mian'an'quan'fang'hu  -  全面安全防护
you'xiang'kai'guan  -  油箱开关
sha'che'qian  -  刹车钳
fen'mo'ye'jin'chan'pin  -  粉末冶金产品
fa'dong'ji'shao'ji'you  -  发动机烧机油
xu'dian'chi'gai  -  蓄电池盖
you'da'deng  -  右大灯
qi'che'si'lun'ding'wei  -  汽车四轮定位
zhang'an'wo'er'wo  -  长安沃尔沃
dou'po'huan'jiang'kong'zhi  -  陡坡缓降控制
dong'feng'chao'chai  -  东风朝柴
jiao'tong'qiang'zhi'xian  -  交通强制险
lun'gang  -  轮缸
yu'kong'he  -  育空河
dong'feng'ri'chan'bei'jing  -  东风日产北京
pao'mo'qing'xi'ji  -  泡沫清洗剂
qi'ya'ou'fei'lai'si  -  起亚欧菲莱斯
bu'lu  -  补炉
qian'gai'ban  -  前盖板
mei'guo'qi'che'xie'hui  -  美国汽车协会
ye'guan'che  -  液罐车
you'hou'bu  -  右后部
xue'fu'lan'le'chi  -  雪佛兰乐驰
wei'deng'zhao  -  尾灯罩
gong'ju'yu'she'bei  -  工具与设备
ye'hua'shi'you'qi'qi'che  -  液化石油气汽车
ke'ni'xi'sai'er  -  柯尼希塞尔
qi'mian'bao'hu'mo  -  漆面保护膜
jia'zhu'kou  -  加注口
qi'che'xin'yong'ka  -  汽车信用卡
yong'yuan'fei'die  -  永源飞碟
che'men'shi'ban  -  车门饰板
qian'bao'xian'gang'xia'bu  -  前保险杠下部
kong'jian'rong'ji  -  空间容积
zhong'kong'fang'xiang'pan  -  中控方向盘
men'beng  -  门泵
shui'beng'ye'lun  -  水泵叶轮
hou'ye'zi'ban  -  后叶子板
ji'xie'bian'su'xiang  -  机械变速箱
you'hou'che'men  -  右后车门
lei'mang'sai'dao  -  勒芒赛道
zu'che'ding  -  阻车钉
jiao'chi  -  角齿
che'men'jiao'lian  -  车门铰链
dian'zi'fa  -  电子阀
zhuan'su'yi  -  转速仪
zui'xiao'zhuan'wan'zhi'jing  -  最小转弯直径
san'jiao'bo'li  -  三角玻璃
nuan'feng'guan  -  暖风管
hou'pai'zhao'ban  -  后牌照板
qian'yin'gou  -  牵引钩
hou'pai'zhao'deng  -  后牌照灯
qian'yin'qi'che  -  牵引汽车
jiang'ling'fu'te  -  江铃福特
shi'guo'che  -  试过车
you'fan'guang'jing  -  右反光镜
shi'xi'si'ji  -  实习司机
shi'zi'cao  -  十字槽
que'gang  -  缺缸
he'bei'rong'hua  -  河北荣华
si'chuan'xian'dai  -  四川现代
nei'gu'jia  -  内骨架
quan'lv'che'shen'kuang'jia'jie'gou  -  全铝车身框架结构
wo'niu'la'ba  -  蜗牛喇叭
ao'si'mo'bi  -  奥斯莫比
feng'jing'ai'er'fa  -  风景爱尔法
yong'cheng'bao'xian  -  永诚保险
fei'lun'chi'quan  -  飞轮齿圈
gan'ying'sai  -  感应塞
mo'pian'dan'huang'li'he'qi  -  膜片弹簧离合器
zhi'dong'deng'kai'guan  -  制动灯开关
feng'jing'chong'lang  -  风景冲浪
leng'mei'guan  -  冷媒管
da'wei'yi  -  大尾翼
qian'feng'chuang'bo'li  -  前风窗玻璃
xia'po'fu'zhu'xi'tong  -  下坡辅助系统
you'hou'ye  -  右后叶
qi'nang'dian'nao  -  气囊电脑
xia'heng'bi  -  下横臂
shao'lin'ke'che  -  少林客车
qi'che'wang'luo'ying'xiao  -  汽车网络营销
qi'che'feng'dong  -  汽车风洞
qi'che'bao'mu  -  汽车保姆
fang'bao'zhi'dong'xi'tong  -  防抱制动系统
chi'cun'bu'he'ge  -  尺寸不合格
yi'er'dang  -  一二档
ye'lun'beng  -  叶轮泵
qi'che'xing'ye'dong'tai  -  汽车行业动态
you'qian'ye  -  右前叶
mo'tuo'che'wei'xiu'gong  -  摩托车维修工
lun'bian'jian'su'qi  -  轮边减速器
quan'che'mo  -  全车膜
guan'xing'piao'yi  -  惯性漂移
xia'men'kan  -  下门槛
duo'qi'men'fa'dong'ji  -  多气门发动机
da'deng'deng'pao  -  大灯灯泡
da'gu'bang  -  大骨棒
dou'shi'jun'ma  -  都市骏马
ao'di'lei'mang  -  奥迪勒芒
zhu'che'deng  -  驻车灯
ban'zi'dong'bian'su'qi  -  半自动变速器
feng'tian'pu'rui'wei'ya  -  丰田普瑞维亚
fu'zhi'lun'gu  -  负值轮毂
zhong'guo'san'ling'la'li'yi'che'dui  -  中国三菱拉力艺车队
bao'yang'quan  -  保养券
si'ba'lu'ao'hu  -  斯巴鲁傲虎
mei'de'ke'che  -  美的客车
dang'wei'gan  -  档位杆
qi'che'yong'chai'you  -  汽车用柴油
jiao'jiao  -  脚胶
zi'dong'gan'ying'da'deng  -  自动感应大灯
nan'jing'fei'ya'te'xi'ye'na  -  南京菲亚特西耶那
wei'duo'li'ya'huang'guan  -  维多利亚皇冠
zhang'an'qi'che'gong'cheng'yan'jiu'yuan  -  长安汽车工程研究院
pai'qi'zhi'dong  -  排气制动
qi'che'tai  -  汽车台
feng'bi'huo'che  -  封闭货车
hou'gang'ban'dan'huang  -  后钢板弹簧
fen'gang'xian  -  分缸线
di'ban'ya'tiao  -  地板压条
qian'bu'shou'sun  -  前部受损
qian'ban'zhou  -  前半轴
kai'lei'de'hun'he'dong'li  -  凯雷德混合动力
xiao'lv'xing'che  -  小旅行车
xie'la'gan  -  斜拉杆
er'shou'che'ji'mai  -  二手车寄卖
zhong'jian'ban  -  中间板
da'xiao'wa  -  大小瓦
guang'jiao'hou'shi'jing  -  广角后视镜
li'he'fen'beng  -  离合分泵
zhuan'xiang'deng'kai'guan  -  转向灯开关
che'men'ge'yin  -  车门隔音
you'ce'wei  -  右侧围
dian'zi'gan'ying'zhi'dong'xi'tong  -  电子感应制动系统
che'xian'ji'suan  -  车险计算
ling'mu'ji'tuan  -  铃木集团
che'nei'yue'du'deng  -  车内阅读灯
bao'shi'jie'xin'ka'yan  -  保时捷新卡宴
qi'nang'kong'zhi'dan'yuan  -  气囊控制单元
cha'che'yong  -  叉车用
ying'tan'huo'che'zhan  -  鹰潭火车站
zhi'tui'dian  -  止推垫
shu'guang'tiao'zhan'zhe  -  曙光挑战者
nuan'feng'kai'guan  -  暖风开关
si'lun'huan'wei  -  四轮换位
a'er'bin'na  -  阿尔宾娜
nuan'feng'dian'ji  -  暖风电机
bao'xian'fa  -  保险阀
bu'qiang'ban  -  补强板
qian'da'deng'zong'cheng  -  前大灯总成
feng'tian'lan'de'ku'lu'ze  -  丰田兰德酷路泽
san'si'dang  -  三四档
you'ban'zhou  -  右半轴
chuan'qi'che'dui  -  川崎车队
you'pin'lei  -  油品类
wan'yu'qi'che'yun'dong'ju'le'bu  -  万宇汽车运动俱乐部
zhao'dian  -  罩垫
ce'wei'ban  -  侧围板
zhong'guo'qi'che'gong'ye'xin'xi'wang  -  中国汽车工业信息网
shi'zi'jie  -  十字节
si'lun'dong'ping'heng  -  四轮动平衡
qi'che'yao'kong'yao'shi  -  汽车遥控钥匙
qian'gang'ban  -  前钢板
zi'dong'kong'diao'kong'zhi'xi'tong  -  自动空调控制系统
dian'dong'sheng'jiang'qi  -  电动升降器
chu'mei'zhuan'huan'qi  -  触媒转换器
ge'yin'chan'pin  -  隔音产品
leng'bu'jiao  -  冷补胶
yi'biao'zhi'shi'deng  -  仪表指示灯
jia'shi'duo'ci'hu  -  嘉实多磁护
lu'bao'jie'you  -  路宝节油
fei'de'la  -  菲德拉
qi'nang'chuan'gan'qi  -  气囊传感器
gang'gu'gang'ji  -  冈谷钢机
qu'zhou'qian  -  曲轴前
xian'bei'shi'wei'men  -  掀背式尾门
yue'ye'ke'che  -  越野客车
shui'lu'liang'qi'qi'che  -  水陆两栖汽车
ke'lu'zi  -  科鲁兹
lu'feng'xin'shi'jie  -  陆风新饰界
fang'hu'bao'mo  -  防护薄膜
dan'xing'dang'quan  -  弹性挡圈
ji'li'zhong'guo'long  -  吉利中国龙
mu'shang  -  慕尚
qing'dong'li'ran'liao'dian'chi'che  -  氢动力燃料电池车
can'liu'ying'li  -  残留应力
rui'dian'wo'er'wo'qi'che'gong'si  -  瑞典沃尔沃汽车公司
zhe'jiang'qi'che'gong'cheng'xue'yuan  -  浙江汽车工程学院
gan'zao'ping  -  干燥瓶
hou'sha'che'fen'beng  -  后刹车分泵
zhi'lou'dou  -  纸漏斗
zi'bu'ye  -  自补液
wan'an'wu'ye'ju'le'bu  -  湾岸午夜俱乐部
shou'kong'fa  -  手控阀
ji'zhao  -  机爪
shui'beng'chu'shui'guan  -  水泵出水管
rui'qi'duo'gong'neng'shang'yong'che  -  锐骐多功能商用车
zhi'jie'dang  -  直接档
diao'qi'she'bei  -  调漆设备
ban'yuan'jian  -  半圆键
ke'lai'si'lei'jiao'cha'huo'li  -  克莱斯勒交叉火力
qi'che'pin'pai'ying'xiao  -  汽车品牌营销
huo'pao'qian'yin'che  -  火炮牵引车
gua'bu'shang'dang  -  挂不上档
ying'lian'jie'qian'yin  -  硬连接牵引
gu'de'wu'de'sai'che'jie  -  古德伍德赛车节
zuo'you'da'deng  -  左右大灯
zheng'zhou'wei'jia'zhuan'ying'dian  -  郑州威佳专营店
hong'xi'li  -  红喜力
tai'ce'jiao  -  胎侧胶
fu'ji'jie'di  -  负极接地
jiao'zhu'su'du  -  浇注速度
ruan'lian'jie'qian'yin  -  软连接牵引
zhi'huan'bu'tie  -  置换补贴
zhen'kong'dian'ci'fa  -  真空电磁阀
xiao'mao'shou'xu  -  小贸手续
xin'neng'yuan'ke'che  -  新能源客车
nei'wen'du'chuan'gan'qi  -  内温度传感器
zhong'hou'qiao  -  中后桥
duo'ning'dun'gong'yuan'sai'dao  -  多宁顿公园赛道
ou'bao'ou'jie'li  -  欧宝欧捷利
si'ke'da'ming'rui  -  斯科达明锐
che'ti'bao'yang  -  车体保养
yan'guang'ming  -  颜光明
yan'hui'gang'gai  -  烟灰缸盖
pi'dai'zhang'jin  -  皮带涨紧
qin'chuan'fu'lai'er  -  秦川福莱尔
qi'che'de'bian'su'qi  -  汽车的变速器
zhong'guo'qi'che'gong'ye'chan'xiao'kuai'xun  -  中国汽车工业产销快讯
kou'qi'jun  -  口奇骏
fang'kong'deng  -  防空灯
xian'dai'ya'ke'shi  -  现代雅科仕
zhe'jiang'qi'che'zhi'ye'ji'shu'xue'yuan  -  浙江汽车职业技术学院
niu'bo'lin'sai'dao  -  纽伯林赛道
gao'jing'du'zhi'pen'xi'tong  -  高精度直喷系统
di'si'gang  -  第四缸
ling'mu'wei'te'la  -  铃木维特拉
fei'du'li'xuan'gua'xi'tong  -  非独立悬挂系统
yi'dang'chi'lun  -  一档齿轮
li'shi'hang'mo'ji  -  立式珩磨机
jian'xie'yu'gua  -  间歇雨刮
bo'li'tuo'jia  -  玻璃托架
ji'lin'qi'che'zhi'dong'qi'chang  -  吉林汽车制动器厂
guo'ji'qi'che'zhi'zao'shang'xie'hui  -  国际汽车制造商协会
ao'si'mo'bi'er  -  奥斯莫比尔
bie'ke'xin'jun'wei  -  别克新君威
qi'che'che'zai'dao'hang  -  汽车车载导航
zhen'kong'diao'ju  -  真空吊具
dian'ya'bian'huan'qi  -  电压变换器
qian'xiao'deng  -  前小灯
quan'zhuang'dan'huang  -  圈状弹簧
lu'su'tou'deng  -  卤素头灯
lu'dao  -  鹿导
xin'feng'rui  -  新锋锐
shan'dong'sheng'qi'che'xing'ye'xie'hui  -  山东省汽车行业协会
mu'dan'ke'che  -  牡丹客车
pen'jiao'chi  -  盆角齿
ge'lan'pi'zhi'da'jiang'sai  -  格兰披治大奖赛
zhen'kong'xi'wu'che  -  真空吸污车
nuan'feng'xin'zi  -  暖风芯子
xiao'mao'che  -  小贸车
ji'mu'xi  -  吉姆希
ji'you'wen'du'biao  -  机油温度表
kao'dian'zi'chuan'gan'qi'tan  -  靠电子传感器探
zhang'cheng'jing'ling'qi'che  -  长城精灵汽车
wei'li'si'ji'pu'che  -  威利斯吉普车
su'du'gan'ying'shi'zhuan'xiang'xi'tong  -  速度感应式转向系统
na'zhi'jie  -  纳智捷
qi'men'shi'dian  -  气门室垫
you'ce'za'wu'he  -  右侧杂物盒
fu'er'jia'che  -  伏尔加车
jing'dian'quan'shun  -  经典全顺
pu'na'de  -  普纳德
zhi'dong'jian'yan'tai  -  制动检验台
qi'che'pen'qi'gong'yi  -  汽车喷漆工艺
shi'jie'chuang'mo'xie'hui  -  世界窗膜协会
you'tian'zhuan'yong'che  -  油田专用车
xiao'xing'leng'cang'che  -  小型冷藏车
qi'che'zheng'xing'ji'shu  -  汽车整形技术
hou'fen'beng  -  后分泵
fu'ke'si'xiao'gai'kuan  -  福克斯小改款
hong'ji'qi'che'ke'yun'zhan  -  宏基汽车客运站
zhu'cong'dong  -  主从动
dan'xing'jiao'zhi'cai'liao  -  弹性胶质材料
you'lu'lou'you  -  油路漏油
yan'che'fei'yong  -  验车费用
zhong'guo'dian'dong'che'xie'hui  -  中国电动车协会
shi'gai'dian  -  室盖垫
ying'te'ge  -  英特格
bu'jia'di'wei'hang  -  布加迪威航
jiao'jie'ke'che  -  铰接客车
wu'di'gai'zhuang'wang  -  无敌改装网
tuan'gou'kan'che  -  团购看车
qi'men'shi'gai'dian  -  气门室盖垫
dao'che'deng'kai'guan  -  倒车灯开关
zhang'zha  -  涨闸
shui'wen'zhi'shi'deng  -  水温指示灯
chu'ye'ping  -  储液瓶
chi'lun'shi'gai  -  齿轮室盖
ou'zhou'xin'che'an'quan'ping'jian'xie'hui  -  欧洲新车安全评鉴协会
jia'shi'yuan'jing'shi'kong'zhi  -  驾驶员警示控制
you'qian'yi'zi'ban  -  右前翼子板
men'deng'kai'guan  -  门灯开关
ling'lu'sai'che'chang  -  铃鹿赛车场
di'ban'pi  -  地板皮
zhong'guo'qi'che'gong'ye'nian'jian  -  中国汽车工业年鉴
dong'feng'ao'ding  -  东风奥丁
shui'wen'gan'ying'sai  -  水温感应塞
xing'xing'chi'lun'bian'su'qi  -  行星齿轮变速器
fei'ya'te'duo'bao  -  菲亚特多宝
shui'wen'deng  -  水温灯
shou'zi'yi'ti'qi'che  -  手自一体汽车
ka'te'han'mu  -  卡特汉姆
you'qian'men'bo'li  -  右前门玻璃
dong'feng'jing'yi  -  东风景逸
ji'you'ru'hua  -  机油乳化
fen'dian'pan'gai  -  分电盘盖
lun'mei'hou  -  轮眉后
xuan'gua'chen'tao  -  悬挂衬套
shi'wei'shi'pin'hui'yi'xi'tong  -  视维视频会议系统
pin'zhuang'tai  -  拼装台
dao'qi'ta'yuan'zhe  -  道奇拓远者
dian'ping'gai  -  电瓶盖
ou'di'ma  -  欧迪玛
dong'feng'pai'xiao'jiao'che  -  东风牌小轿车
yao'bi'zong'cheng  -  摇臂总成
zhu'you'guan  -  注油管
ba'lin'guo'ji'sai'dao  -  巴林国际赛道
qi'che'gong'cheng'shou'ce  -  汽车工程手册
shou'dong'bian'su'xiang'you  -  手动变速箱油
luo'mu'dian'pian  -  螺母垫片
you'ke'hao'ma'lun'tai  -  优科豪马轮胎
bei'qi'jiao'dou'shi  -  北汽角斗士
bao'xian'gang'ge'zha  -  保险杠格栅
quan'che'dian  -  全车垫
xia'bian'liang  -  下边梁
jie'che'dan  -  接车单
qi'che'hua'gong'yong'pin  -  汽车化工用品
de'guo'yin'xiang  -  德国音响
ye'dan'jia'su  -  液氮加速
fang'zhui'wei'xi'tong  -  防追尾系统
bao'wen'mao'kou  -  保温冒口
gang'ban'tao  -  钢板套
zhi'dong'diao'zheng'bi  -  制动调整臂
ti'jian'hui'zhi  -  体检回执
qi'che'jia'qi'zhan'cao'zuo'gong  -  汽车加气站操作工
tao'tao'er'shou'che  -  淘淘二手车
zhi'tui'dian'pian  -  止推垫片
zuo'yi'ji'fu'jian  -  座椅及附件
qi'che'dian'qi'she'bei'yu'wei'xiu  -  汽车电器设备与维修
bao'xian'gang'zhi'jia  -  保险杠支架
ji'jiao'jiao  -  机脚胶
fang'dao'kong'zhi'dan'yuan  -  防盗控制单元
qian'gang'ban'dan'huang  -  前钢板弹簧
kou'can  -  扣残
you'qian'ye'zi'ban  -  右前叶子板
yin'qing'gai'ge'yin  -  引擎盖隔音
qi'che'zhu'dong'an'quan'xing  -  汽车主动安全性
li'qu'jiao'du  -  离去角度
ao'jie'qi'che'wang  -  奥杰汽车网
you'bao'xian'gang  -  右保险杠
che'tie'wen'hua  -  车贴文化
de'guo'man'ji'tuan  -  德国曼集团
bao'xian'jia  -  保险夹
zhe'jiang'yong'yuan'qi'che'you'xian'gong'si  -  浙江永源汽车有限公司
chu'lu'kou  -  出炉口
jie'qi'men'kong'zhi'dan'yuan  -  节气门控制单元
zui'da'pa'po'jiao  -  最大爬坡角
fa'dong'ji'que'gang  -  发动机缺缸
jing'cheng'hai'shi  -  京城海狮
zhuan'wan'zhi'shi'deng  -  转弯指示灯
huo'xing'tan'guan'dian'ci'fa  -  活性炭罐电磁阀
liu'jiao'fa'lan'mian  -  六角法兰面
zhi'pen'shi'ran'shao'shi  -  直喷式燃烧室
zhi'dong'di'ban  -  制动底板
mai'chong'chuan'gan'qi  -  脉冲传感器
ji'zhao'dian  -  机爪垫
dang'feng'bo'li'yu'gua'qi  -  挡风玻璃雨刮器
si'lun'bao'yang  -  四轮保养
su'zhou'er'shou'che'wang  -  苏州二手车网
li'shi'jing'tang'chuang  -  立式精镗床
ji'nan'ye'ya'beng  -  济南液压泵
sheng'ma'li'nuo'yi'mo'la'sai'dao  -  圣马力诺伊莫拉赛道
ce'hua'shi'yan'tai  -  侧滑试验台
yi'biao'deng'pao  -  仪表灯泡
qing'dong'si'hao  -  氢动四号
zi'dong'bu'tai'ye  -  自动补胎液
che'lun'shi'gai  -  车轮饰盖
ma'zi'da'jin'xiang  -  马自达劲翔
quan'che'suo'xin  -  全车锁芯
huan'dang'dian'ci'fa  -  换挡电磁阀
li'si'te'gong'si  -  李斯特公司
qi'men'gai  -  气门盖
you'hou'wei'deng  -  右后尾灯
dian'chi'he'shou'bing  -  电池盒手柄
men'jiao'tiao  -  门胶条
yu'gua'jing  -  雨刮精
zhong'ke'hua'bei  -  中客华北
kong'diao'ya'suo'ji'pi'dai  -  空调压缩机皮带
zhuan'xiang'heng'la'gan'qiu'tou  -  转向横拉杆球头
chu'lu'wen'du  -  出炉温度
shen'nong'jia  -  神农驾
zhen'tan'quan  -  侦探犬
fa'dong'ji'zhuan'yong'ji'you  -  发动机专用机油
tian'he'qi'che'zhan  -  天河汽车站
xia'dao'liu'ban  -  下导流板
fa'dong'ji'tuo'jia  -  发动机托架
you'jiao'ta'ban  -  右脚踏板
ao'men'da'sai'che'bo'wu'guan  -  澳门大赛车博物馆
bi'de'bi'er'te'gong'si  -  彼得比尔特公司
zhong'cheng'hai'hua  -  中诚海华
ji'dong'che'yi'dong'zheng  -  机动车移动证
ji'you'gan'ying'sai  -  机油感应塞
che'zai'ying'die'ji  -  车载影碟机
xin'che'die'bao  -  新车谍报
kong'diao'gao'ya'guan  -  空调高压管
bei'jing'ben'chi'bo'rui  -  北京奔驰铂锐
qi'men'shi'zhao'gai  -  气门室罩盖
quan'guo'qi'che'yun'dong'guan'li'gui'ding  -  全国汽车运动管理规定
luo'si'mao'ding  -  螺丝铆钉
huang'you'jia'zhu'ji  -  黄油加注机
zuo'hou'lun'mei  -  左后轮眉
dian'dong'yao'ji  -  电动摇机
hou'tai'ban  -  后台板
xin'jia'po'sai'dao  -  新加坡赛道
qian'bao'xian'gang'xia'hu'ban  -  前保险杠下护板
zhuan'xiang'zhi'la'gan  -  转向直拉杆
kong'yong'dan'xing'dang'quan  -  孔用弹性挡圈
shui'beng'jin'shui'guan  -  水泵进水管
yi'wei'ke'bao'di  -  依维柯宝迪
chong'han'qiao  -  冲焊桥
you'hou'men'bo'li  -  右后门玻璃
qi'che'pan'shi'zhi'dong'qi  -  汽车盘式制动器
qi'lu'ke'che  -  齐鲁客车
gua'dang'ji'gou  -  挂档机构
huang'guan'rui'zhi  -  皇冠锐志
sui'dong'zha  -  随动闸
zhu'li'zhuan'xiang'diao'jie  -  助力转向调节
jie'bei'shi'jiao'che  -  阶背式轿车
ri'chan'gong'jue'wang  -  日产公爵王
yuan'guang'zhi'shi'deng  -  远光指示灯
zhang'feng'lie'bao'hei'jin'gang  -  长丰猎豹黑金刚
zuo'hou'men'bo'li  -  左后门玻璃
hou'shi'ban  -  后饰板
gong'zi'ban  -  弓子板
can'liu'qiang'du  -  残留强度
qian'yan'hui'gang  -  前烟灰缸
ban'zhou'tu'yuan  -  半轴突缘
jin'gang'er'dai  -  金刚二代
che'shen'zhu'dong'kong'zhi'xi'tong  -  车身主动控制系统
you'dao'che'jing  -  有倒车镜
jia'qiang'di'ban  -  加强底板
xin'fu'da'qi'che  -  新福达汽车
yi'biao'tai'zong'cheng  -  仪表台总成
xi'di'beng  -  洗涤泵
yi'qi'ke'che'you'xian'gong'si  -  一汽客车有限公司
xin'yi'dai'pu'li'ma  -  新一代普力马
fei'quan'chi'cun'bei'tai  -  非全尺寸备胎
zhan'xing'lian'zhou'jie  -  粘性联轴节
che'nei'wen'du'chuan'gan'qi  -  车内温度传感器
si'xing'cheng'yin'qing  -  四行程引擎
huo'sai'xiao  -  活塞肖
qi'men'yao'bi'zhou  -  气门摇臂轴
che'lun'dong'ping'heng'ji  -  车轮动平衡机
che'shen'xiao'zheng'she'bei  -  车身校正设备
de'mi'ou  -  德米欧
gong'tie'liang'yong'che  -  公铁两用车
ka'tong'mo'tuo  -  卡通摩托
bian'su'xiang'yi'zhou  -  变速箱一轴
di'zu'che'wang  -  迪族车网
ri'chan'ping'tai  -  日产平台
ao'ke'lan'qi'che'gong'si  -  奥克兰汽车公司
qi'che'chuan'gan'qi'de'jian'ce  -  汽车传感器的检测
jin'kou'da'qie'nuo'ji  -  进口大切诺基
xi'huo'qi  -  熄火器
zi'dong'zhi'dong'cha'su'qi  -  自动制动差速器
qian'xin'hao'deng  -  前信号灯
dian'zi'cha'su'zhi'dong  -  电子差速制动
shou'gong'yang'pin  -  手工样品
qi'che'mo'ni'jia'shi'xi'tong  -  汽车模拟驾驶系统
dian'ci'jian'zhen'qi  -  电磁减震器
nuan'feng'ji'zong'cheng  -  暖风机总成
huan'qi'men'dao'guan  -  换气门导管
bao'xian'he'gai  -  保险盒盖
ji'pu'ai'guo'zhe  -  吉普爱国者
dong'feng'ri'chan'qi'jun  -  东风日产奇骏
fu'tian'feng'jing'chong'lang  -  福田风景冲浪
hui'you'lv'xin  -  回油滤芯
qian'men'kuang  -  前门框
qu'zhou'zhi'tui'pian  -  曲轴止推片
zi'dong'cao'zong'shi'bian'su'qi  -  自动操纵式变速器
gang'guan'wan'tou  -  钢管弯头
re'kong'zhi'fa  -  热控制阀
you'xiao're'xiao'lv  -  有效热效率
ran'you'zheng'fa'pai'fang'kong'zhi  -  燃油蒸发排放控制
you'di'ke'dian  -  油底壳垫
yin'di'che'sai  -  印地车赛
you'hou'ye'zi'ban  -  右后叶子板
yi'suan'ding'suan'xian'wei'su  -  乙酸丁酸纤维素
qian'fen'beng  -  前分泵
fang'tuo'che'xi'tong  -  防拖车系统
mo'chen'bu  -  抹尘布
men'fang'zhuang'tiao  -  门防撞条
mao'mu'sai'dao  -  茂木赛道
men'bian'shi'tiao  -  门边饰条
zhi'dong'ta'ban'zong'cheng  -  制动踏板总成
lian'gan'zhou'cheng'gai  -  连杆轴承盖
fang'huo'qiang'ge'yin  -  防火墙隔音
zhu'dong'fen'pin  -  主动分频
qi'che'pin'pai'yu'shang'biao  -  汽车品牌与商标
qi'che'fu'wu'ju'le'bu  -  汽车服务俱乐部
la'ba'an'niu'kai'guan  -  喇叭按钮开关
feng'dang'gua'shui'qi  -  风档刮水器
xi'huo'dian'ci'fa  -  熄火电磁阀
you'hu'ban  -  右护板
yi'qi'ji'lin'sen'ya  -  一汽吉林森雅
quan'che'dao'qiang'sun'shi'xian  -  全车盗抢损失险
jin'qi'ya'li'wen'du'chuan'gan'qi  -  进气压力温度传感器
qi'che'shi'yong'cha'xun  -  汽车实用查询
de'zhong'guo'zhe'de'tian'xia  -  得中国者得天下
an'quan'tu'mian'jing  -  安全凸面镜
hou'qiao'duan'zhou  -  后桥短轴
fu'jia'shi'wei'qi'nang  -  副驾驶位气囊
chao'zhong'xing'qi'che'lie'che  -  超重型汽车列车
zhan'xing'ou'he'qi  -  粘性偶合器
zhong'guo'qi'mo'pin'dao  -  中国汽摩频道
da'mo'pao'guang'she'bei  -  打磨抛光设备
zuo'ce'chuang'bo'li  -  左侧窗玻璃
zhen'duan'cha'tou  -  诊断插头
heng'bai'li'ou'ju  -  横摆力偶矩
xing'xing'chi'lun'zhuang'zhi  -  行星齿轮装置
qian'lun'gu  -  前轮鼓
zi'dong'che'wei'suo  -  自动车位锁
fan'zhuan'zhou  -  翻转轴
liu'jiao'fa'lan'mian'luo'shuan  -  六角法兰面螺栓
xin'neng'yuan'dian'dong'qi'che  -  新能源电动汽车
qi'gang'gai'dian'pian  -  气缸盖垫片
che'su'biao'jian'yan'tai  -  车速表检验台
zhou'cheng'chen'tao  -  轴承衬套
qi'men'dan'huang'zuo  -  气门弹簧座
you'hao'chuan'gan'qi  -  油耗传感器
xiao'sheng'qi'wei  -  消声器尾
ma'nao'hui  -  玛瑙灰
cha'su'qi'xing'xing'chi'lun  -  差速器行星齿轮
pai'qi'zhi'dong'fa  -  排气制动阀
qi'che'shi'pin'tao  -  汽车饰品套
qi'che'zeng'zhi'shui  -  汽车增值税
zuo'hou'ye  -  左后叶
xin'hao'la'ba  -  信号喇叭
dang'wei'zhi'shi'qi  -  挡位指示器
yuan'guang'deng'pao  -  远光灯泡
che'guan'xue'yuan  -  车管学院
gua'che'fa  -  挂车阀
ji'xie'zeng'ya'yu'wo'lun'zeng'ya  -  机械增压与涡轮增压
you'bian'tiao  -  右边条
qi'nang'dian'nao'ban  -  气囊电脑板
bi'ya'di'qin  -  比亚迪秦
le'che'wang  -  乐车网
pa'nuo'zi  -  帕诺兹
gua'dang'gan  -  挂档杆
qian'sha'che'fen'beng  -  前刹车分泵
yan'bian'er'shou'che'wang  -  延边二手车网
jin'qi'jie'guan  -  进气接管
liu'jiao'hou'luo'mu  -  六角厚螺母
zuo'hou'yi'zi'ban  -  左后翼子板
dian'ping'lian'jie'xian  -  电瓶连接线
da'deng'bao'xian'gang  -  大灯保险杠
ying'ji'deng'kai'guan  -  应急灯开关
ao'bu'wei  -  奥布维
luo'wen'ban  -  螺纹板
dian'huo'xian'quan'zong'cheng  -  点火线圈总成
zuo'hou'ye'zi'ban  -  左后叶子板
pa'jie'luo'zhao'hui'shi'jian  -  帕杰罗召回事件
liu'jiao'suo'jin'luo'mu  -  六角锁紧螺母
jia'shi'pi'lao'yu'jing'xi'tong  -  驾驶疲劳预警系统
zhang'jia'gang'qi'che'wang  -  张家港汽车网
hou'zhi'dong'mo'ca'pian  -  后制动摩擦片
you'qian'zhuan'xiang'deng  -  右前转向灯
lun'zhao'hu'ban  -  轮罩护板
zhong'jian'chuan'dong'zhou  -  中间传动轴
yang'ban'che  -  样版车
zhong'guo'guo'ji'qi'che'zhan'lan'hui  -  中国国际汽车展览会
yi'ji'fang'cheng'xu'sai'che  -  一级方程序赛车
qi'lu'kong'zhi'fa  -  气路控制阀
you'qian'lun'mei  -  右前轮眉
ai'mo'lv  -  爱墨绿
gong'lu'ke'yun'shou'piao  -  公路客运售票
ji'gai'cheng'gan  -  机盖撑杆
zheng'shi'pi'dai'zhang'jin'lun  -  正时皮带涨紧轮
you'hou'yi'zi'ban  -  右后翼子板
si'dang'chi  -  四档齿
qian'pai'zhao'jia  -  前牌照架
zhen'duan'bao'jing'xi'tong  -  诊断报警系统
qian'zhi'dong'qian  -  前制动钳
yi'ka'lu'si  -  依卡露斯
ya'ge'lv'xing'ban'gai'nian'che  -  雅阁旅行版概念车
zhi'dong'ban  -  止动板
bing'suan'xian'wei'su  -  丙酸纤维素
fang'xiang'pan'gai  -  方向盘盖
yi'qi'hua'li'xing'fu'shi'zhe  -  一汽华利幸福使者
ji'you'jia'zhu'kou'gai  -  机油加注口盖
fu'he'chen'tao  -  复合衬套
bai'xin'ke'duan'zhu'tie  -  白心可锻铸铁
zuo'qian'men'nei'shi'ban  -  左前门内饰板
da'deng'kuang  -  大灯框
xi'bao'ran'shao'fa'dong'ji  -  稀薄燃烧发动机
zhuan'xiang'chi'lun'beng  -  转向齿轮泵
kong'diao'zhang'jin'lun  -  空调涨紧轮
zuo'you'ke  -  左右壳
fu'tian'mi'di  -  福田迷迪
nuan'feng'jiao'guan  -  暖风胶管
yin'qing'bao  -  引擎宝
you'xia'bian'liang  -  右下边梁
ren'che'he'ying  -  人车合影
mao'xian'ya  -  冒险鸭
qian'bao'xian'gang'mian'ban  -  前保险杠面板
hang'zhou'jia'nuo'zhan'lan'you'xian'gong'si  -  杭州嘉诺展览有限公司
qian'zhi'dong'mo'ca'pian  -  前制动摩擦片
qu'zhou'qian'you'feng  -  曲轴前油封
qu'dong'xiao'chi'lun  -  驱动小齿轮
you'ce'chuang'bo'li  -  右侧窗玻璃
qing'qi'zhuan'zi'fa'dong'ji  -  氢气转子发动机
dian'ping'ka'zi  -  电瓶卡子
pa'ke'wo'de  -  帕克沃德
er'xing'cheng'xun'huan'yin'qing  -  二行程循环引擎
hao'ci'ku  -  好词库
peng'zhang'fa  -  膨涨阀
hou'wei'deng'zhao  -  后尾灯罩
gai'zhuang'ji'shu'ren'yuan  -  改装技术人员
chuan'lian'shi'zhi'dong'zong'beng  -  串联式制动总泵
xin'jiu'jian  -  新旧件
qi'che'zhuang'shi'fu'wu'zhong'xin  -  汽车装饰服务中心
tai'kong'hu  -  太空户
qian'shui'pao'che  -  潜水跑车
lun'tai'luo'mu'chai'zhuang'ji  -  轮胎螺母拆装机
liang'xiang'ban'shi'jiao'che  -  两厢半式轿车
zhi'dong'ying'guan  -  制动硬管
yi'zi'ban'ge'yin  -  翼子板隔音
fu'gang'ban  -  付钢板
mei'gang'qi'men'shu  -  每缸气门数
dian'dong'che'zhuan'yong'pei'jian  -  电动车专用配件
mian'ban'zhuang'shi'jian  -  面板装饰件
shi'che'ping'ce  -  试车评测
ha'fei'lu'zun'xiao'ba'wang  -  哈飞路尊小霸王
xiao'sheng'qi'jie'guan  -  消声器接管
qi'che'che'ti'jie'gou  -  汽车车体结构
si'chong'cheng'xun'huan  -  四冲程循环
ge'yin'pin'pai  -  隔音品牌
dang'ba'cha  -  档拔叉
shui'beng'bu'jian  -  水泵部件
zhuan'ju'bian'huan'qi  -  转矩变换器
yu'gua'jian'xie'ji'dian'qi  -  雨刮间歇继电器
you'dong'chi'lun  -  游动齿轮
ling'mu'hong  -  铃木红
che'liang'wai'qian  -  车辆外迁
hou'bao'xian'gang'mian'ban  -  后保险杠面板
xiang'jiao'bao'hu'mao  -  橡胶保护帽
shui'wei'gan'ying'qi  -  水位感应器
che'men'kai'du'xian'wei'qi  -  车门开度限位器
zhuan'xiang'deng'deng'pao  -  转向灯灯泡
lu'huan'xiao'xing'sai'che'chang  -  路环小型赛车场
lian'gan'xiao'zheng'qi  -  连杆校正器
qi'che'ling'bu'jian'zheng'he  -  汽车零部件整合
ye'zi'ban'nei'chen  -  叶子板内衬
dian'zi'zhen'kong'beng  -  电子真空泵
yan'hui'gang'qian  -  烟灰缸前
ding'yuan'shi'che'chang  -  定远试车场
you'xiao'ran'you'xiao'hao'lv  -  有效燃油消耗率
dai'shu'xie'jiao'lun'tai  -  带束斜交轮胎
zhong'xing'qi'che'lian'ying'gong'si  -  重型汽车联营公司
jin'qi'tu'lun'zhou'qian  -  进气凸轮轴前
zhuan'xiang'jie'qian  -  转向节前
bei'shi'ti'qiu'mo'zhu'tie  -  贝氏体球墨铸铁
lun'tai'fan'xin'cai'liao  -  轮胎翻新材料
xing'xing'chi'lun'bian'su'ji'gou  -  行星齿轮变速机构
ban'zi'dong'cao'zong'shi'bian'su'qi  -  半自动操纵式变速器
gai'duo'che  -  改舵车
zhong'guo'si'da'qi'che'ji'tuan  -  中国四大汽车集团
you'hou'lun'mei  -  右后轮眉
hou'wei'ce'ban  -  后围侧板
zuo'qian'men'bo'li'sheng'jiang'qi  -  左前门玻璃升降器
bian'xie'you'xiang  -  便携油箱
qi'che'zhi'dong'xiao'neng  -  汽车制动效能
ke'ni'xi'si'ai'ge  -  柯尼希斯埃格
fei'qi'hui'shou'guan  -  废气回收管
ge'yin'cai'liao'chang  -  隔音材料厂
xing'xing'chi'lun'tuo'jia  -  行星齿轮托架
huang'hai'qi'che'gong'cheng'xue'yuan  -  黄海汽车工程学院
qi'che'zhi'neng'yao'shi  -  汽车智能钥匙
wen'ding'qian'yin'kong'zhi'xi'tong  -  稳定牵引控制系统
bo'li'yao'ba  -  玻璃摇把
fen'ge'shi'ran'shao'shi  -  分隔式燃烧室
shou'kou'fang'hua'mo  -  手扣防划膜
jian'mo'dian'pian  -  减磨垫片
feng'shan'ou'he'qi  -  风扇偶合器
men'ti'niu  -  门提钮
qian'bao'xian'gang'gu'jia  -  前保险杠骨架
shuang'yao'bi'xuan'jia  -  双摇臂悬架
mei'ge'na'si'te'ye  -  梅格纳斯特耶
gang'ban'jiao'tao  -  钢板胶套
bian'su'xiang'kai'guan  -  变速箱开关
ye'ya'shi'li'he'qi'xi'tong  -  液压式离合器系统
qi'che'qi'dong'dian'yuan  -  汽车启动电源
bian'su'xiang'di'yi'zhou  -  变速箱第一轴
qi'che'zui'xiao'li'di'jian'xi  -  汽车最小离地间隙
liu'jiao'fa'lan'mian'luo'mu  -  六角法兰面螺母
cong'dong'yuan'zhu'chi  -  从动圆柱齿
huan'dang'suo'zhi'dian'ci'fa  -  换挡锁止电磁阀
zhuan'xiang'guan'zhu'zong'cheng  -  转向管柱总成
xin'jia'nian'hua'liang'xiang  -  新嘉年华两厢
tu'yuan'cha  -  凸缘叉
zhong'guo'zhuan'yong'qi'che'wang  -  中国专用汽车网
cong'dong'yuan'zhu'chi'lun  -  从动圆柱齿轮
yin'qing'gai'fu'mo  -  引擎盖覆膜
xia'jiao'dian  -  下脚垫
lun'tai'ce'pian'gang'du  -  轮胎侧偏刚度
zhong'guo'qi'mao'wang  -  中国汽贸网
fei'xing'ji'pu  -  飞行吉普
shu'zi'shi'wan'yong'dian'biao  -  数字式万用电表
qian'men'jiao'ta  -  前门脚踏
ji'you'leng'que'qi'xin  -  机油冷却器芯
hou'pai'feng'chu'kou  -  后排风出口
feng'tian'zhi'hui  -  丰田智慧
cheng'yuan'tou'jing'bao'hu'xi'tong  -  乘员头颈保护系统
chuan'dong'zhou'tu'yuan  -  传动轴凸缘
xiang'xin'gun'zhu'zhou'cheng  -  向心滚珠轴承
fu'te'quan'shun'kuai'yun  -  福特全顺快运
fang'zhuang'jia'qiang'ban  -  防撞加强板
gang'bi'ya'hong  -  冈比亚红
hu'feng'quan  -  护风圈
lun'bian'jian'su'qi'zong'cheng  -  轮边减速器总成
ya'er'pa  -  亚尔帕
jin'niu'zuo'qi'che  -  金牛座汽车
ye'li'zhuan'xiang'beng  -  液力转向泵
you'hou'dang'ni'ban  -  右后挡泥板
zhong'da'jin'ling'ke'che  -  中大金陵客车
pai'qi'men'da  -  排气门大
you'qian'che'men'bo'li  -  右前车门玻璃
qian'zhao'ke  -  前罩壳
xie'bei'shi'jiao'che  -  斜背式轿车
zhan'jiang'qi'che'wang  -  湛江汽车网
mei'sai'de'si'ben'chi  -  梅塞得斯奔驰
pu'li'mao'si'qi'che'gong'si  -  普利茅斯汽车公司
zhu'li'beng'kai'guan  -  助力泵开关
ge'lei'na'da  -  格雷那达
he'gai'zuo  -  盒盖左
an'quan'qi'nang'xian'shu  -  安全气囊线束
mai'chong'shi'dian'ci'fa  -  脉冲式电磁阀
xie'xing'xiao  -  楔形销
shui'xiang'jiao'dian  -  水箱胶垫
shui'xiang'fu'shui'hu  -  水箱副水壶
zhi'dong'deng'kai'guan'zong'cheng  -  制动灯开关总成
san'xiao'cui'hua'qi  -  三效催化器
quan'tian'hou'kong'diao'xi'tong  -  全天候空调系统
xie'zhen'xiang  -  谐振箱
quan'xi'zuo'cang  -  全息座舱
you'beng'dan'xiang'fa  -  油泵单向阀
shui'beng'dian  -  水泵垫
zhong'jian'tuo'jia  -  中间托架
qian'wei'xian'shu  -  前围线束
gua'che'zhi'shi'deng  -  挂车指示灯
tai'quan'xin  -  胎圈芯
fei'li'pu'dao'sai'dao  -  菲利普岛赛道
lv'xin'zong'cheng  -  滤芯总成
zheng'fa'qi'xin'zi  -  蒸发器芯子
ka'ya'ke  -  卡亚克
lu'an'qi'che'ju'le'bu  -  路安汽车俱乐部
ge'lei'mu'lin  -  格雷姆林
ji'gai'jiao'lian  -  机盖铰链
zuo'yi'diao'zheng'qi  -  座椅调整器
qi'che'ji'dian'ji'shu  -  汽车机电技术
mo'lv'zhen'zhu  -  墨绿珍珠
yuan'zhui'zhu'dong'chi'lun'zhou'cheng  -  圆锥主动齿轮轴承
zhuan'xiang'lun'ding'wei'yi  -  转向轮定位仪
pen'you'beng'chi'lun  -  喷油泵齿轮
xian'dai'qi'che'jian'ce'zhen'duan'ji'shu  -  现代汽车检测诊断技术
chuan'qi'ye'ma  -  川汽野马
jiao'dian'hei'se  -  脚垫黑色
ou'ya'che'ye  -  欧亚车业
you'jiao'deng  -  右角灯
xia'xuan'gua'jiao'tao  -  下悬挂胶套
ke'lai'si'lei'zhi'hui'guan  -  克莱斯勒指挥官
wen'du'chuan'gan'qi'xian'shu  -  温度传感器线束
qi'che'ping'shun'xing'sui'ji'shu'ru'xing'shi'shi'yan  -  汽车平顺性随机输入行驶试验
yin'di'fang'cheng'shi'sai  -  印地方程式赛
you'zhong'bao  -  油中宝
qi'che'lun'ju  -  汽车轮距
qi'che'meng'gong'chang  -  汽车梦工场
qi'che'qian'yin'li'kong'zhi'xi'tong  -  汽车牵引力控制系统
ha'fei'qi'che'lu'bao  -  哈飞汽车路宝
jie'qi'men'dian  -  节气门垫
jin'ji'kong'zhi'fa  -  紧急控制阀
qi'che'dian'nao'wei'xiu'jiao'cheng  -  汽车电脑维修教程
bo'shi'wo'niu'la'ba  -  博世蜗牛喇叭
man'hu'mo'er'ji'tuan  -  曼胡默尔集团
zui'xin'qi'che'zheng'shi'xiao'dui'shou'ce  -  最新汽车正时校对手册
hou'lun'zhao'hu'ban  -  后轮罩护板
zhang'an'fu'te'xin'fu'ke'si  -  长安福特新福克斯
zuo'hou'men'bo'li'sheng'jiang'qi  -  左后门玻璃升降器
li'he'qi'gai'ji'ya'pan'zong'cheng  -  离合器盖及压盘总成
you'qian'xiao'deng  -  右前小灯
zuo'qian'fen'beng  -  左前分泵
niu'li'zhi'jia  -  扭力支架
fa'she'ji'ou'he'luo'ji'dian'lu  -  发射极耦合逻辑电路
bei'mei'zhi'ying'hao  -  北美之鹰号
qi'you'ye'wei'chuan'gan'qi  -  汽油液位传感器
yue'si'di  -  约斯帝
zhong'jian'chuan'dong'chi'lun  -  中间传动齿轮
yin'qing'bo'si  -  引擎波司
zheng'zhou'bei'huan'qi'pei'che'shi'guang'chang  -  郑州北环汽配车饰广场
jiang'su'nv'shen'qi'che'ji'tuan'gong'si  -  江苏女神汽车集团公司
bei'mei'zhi'ying  -  北美之鹰
che'liang'wen'ding'xing'cao'kong'xi'tong  -  车辆稳定性操控系统
pai'qi'guan'ge're'ban  -  排气管隔热板
qi'che'yin'xiang'jie'ma'da'quan  -  汽车音响解码大全
yong'ci'jian'su'qi'dong'ji  -  永磁减速起动机
pin'che'wang  -  品车网
qian'gang'gu'jia  -  前杠骨架
jin'qi'men'yao'bi  -  进气门摇臂
zhong'jian'zhou'chang'nie'he'chi'lun  -  中间轴常啮合齿轮
lun'bian'zong'cheng  -  轮边总成
zhong'kong'chong'na'qi'men  -  中空充钠气门
qi'men'diao'zheng'luo'si  -  气门调整螺丝
kong'diao'pi'dai'zhang'jin'lun  -  空调皮带张紧轮
chu'sheng'shi'mo  -  初生石墨
zhu'che'zhi'dong'zhi'shi'deng  -  驻车制动指示灯
zhang'feng'lie'bao'qi'ling  -  长丰猎豹骐菱
bao'xian'ji'dian'qi  -  保险继电器
qi'che'niu'ju  -  汽车扭矩
qi'che'ping'shun'xing'dan'mai'chong'shu'ru'xing'shi'shi'yan  -  汽车平顺性单脉冲输入行驶试验
ye'ya'you'ya'li'biao  -  液压油压力表
yin'di'an'na'sai'dao  -  印第安纳赛道
jia'hua'qi'ya  -  嘉华起亚
gang'quan'qing'xi'ji  -  钢圈清洗剂
qu'zhou'wei'zhi'gan'ying'qi  -  曲轴位置感应器
ye'zi'ban'deng  -  叶子板灯
she'ji'ying'dian  -  设计硬点
zuo'hou'ce'wei  -  左后侧围
dong'li'zhuan'xiang'you'guan'zong'cheng  -  动力转向油罐总成
pai'zhao'deng'hu'ban  -  牌照灯护板
zhu'hai'qi'che'wang  -  珠海汽车网
zhao'gai'dian  -  罩盖垫
cha'su'qi'xiao'chi'lun  -  差速器小齿轮
bo'nuo'sai'dao  -  伯诺赛道
yu'gua'gai'ban  -  雨刮盖板
qi'che'an'quan'jia'shi'ji'shu  -  汽车安全驾驶技术
qian'gang'ban'hou'zhi'jia  -  前钢板后支架
zhen'kong'guan'ying  -  真空管硬
tong'yong'jian'yu'biao'zhun'jian  -  通用件与标准件
yue'ye'che'lun'tan  -  越野车论坛
huan'qi'men'zuo'quan  -  换气门座圈
gu'feng'ji'ke  -  鼓风机壳
mo'tuo'che'fang'shai'dian  -  摩托车防晒垫
kong'diao'nuan'feng'kai'guan  -  空调暖风开关
ban'zhou'chi'lun'dian  -  半轴齿轮垫
can'que'lei'que'xian  -  残缺类缺陷
jia'shi'shi'jian'zhen'qi  -  驾驶室减震器
gong'you'ti'qian'qi  -  供油提前器
fen'mo'ye'jin'chen'tao  -  粉末冶金衬套
shan'xi'yu'xing'ke'che'you'xian'gong'si  -  山西宇星客车有限公司
qian'sha'che'fen'beng'zhi'jia  -  前刹车分泵支架
qi'che'pin'pai'yu'wen'hua  -  汽车品牌与文化
qu'qian'you'feng  -  曲前油封
rong'mao'ge'yin  -  荣茂隔音
zuo'you'ce'gai  -  左右侧盖
quan'fang'wei'che'ti'xi'zhuang'jie'gou  -  全方位车体吸撞结构
fa'la'li'yue'ye'che  -  法拉利越野车
qi'che'dong'li'zhi'biao  -  汽车动力指标
qian'zhi'dong'fen'shi  -  前制动分室
qian'gang'ban'qian'zhi'jia  -  前钢板前支架
lun'bian'ke  -  轮边壳
mao'xian'fa'la'li  -  毛线法拉利
jin'qi'dao'zhuan'huan'fa  -  进气道转换阀
gao'nong'du'gu'hua'ji  -  高浓度固化剂
you'lu'zong'cheng'ce'shi'ji  -  油路总成测试机
kai'yue'qian'dang'bo'li  -  凯越前挡玻璃
zhou'shen'yi  -  周申一
qu'zhou'wei'zhi'gan'zhi'qi  -  曲轴位置感知器
gu'feng'ji'dian'zu  -  鼓风机电阻
ma'xi'la'di  -  玛希拉蒂
mo'pian'shi'zhi'dong'qi'shi  -  膜片式制动气室
meng'di'bo'lang  -  梦迪博朗
ou'zhou'niu'bo'ge'lin'sai'dao  -  欧洲纽博格林赛道
lun'xin'gai  -  轮芯盖
bian'su'xiang'yi'zhou'you'feng  -  变速箱一轴油封
gang'quan'lv  -  钢圈铝
qian'zhi'dian  -  前止点
gang'ban'dian'kuai  -  钢板垫块
bian'niu'qi'qie'ge'she'bei  -  变扭器切割设备
ye'ma'fu'te  -  野马福特
biao'zhun'xing'dan'huang'dian'quan  -  标准型弹簧垫圈
zhi'la'gan'jie'tou'zong'cheng  -  直拉杆接头总成
zhi'dong'gu'hou  -  制动鼓后
chong'dian'ka'zi  -  充电卡子
ge'zha'bao'xian'gang  -  格栅保险杠
zhe'jiang'rui'li'ji'tuan'gong'si  -  浙江瑞立集团公司
mo'na'luo  -  摩纳罗
wei'deng'zhi'jia  -  尾灯支架
you'xiang'fu'tong  -  油箱浮筒
qi'che'zhi'neng'an'quan'qi'nang  -  汽车智能安全气囊
qi'che'zui'da'pa'po'du  -  汽车最大爬坡度
wan'xiang'ye'ya  -  万向液压
su'qian'ke'yun'zong'zhan  -  宿迁客运总站
you'hou'ce'wei  -  右后侧围
ming'che'bei'hou'de'gu'shi  -  名车背后的故事
yuan'zhu'chi'lun'ke  -  圆柱齿轮壳
qi'che'yong'pin'yu'fu'jian  -  汽车用品与附件
qi'che'zi'dong'bian'su'qi'dang'wei  -  汽车自动变速器挡位
fang'sui'an'quan'bo'li  -  防碎安全玻璃
ma'zi'da'ba  -  马自达八
feng'hua'yi'hao  -  风华一号
hou'bei'xiang'gai'ge'yin  -  后备箱盖隔音
lun'mei'ka'kou  -  轮眉卡扣
ma'li'che'zhong'bi  -  马力车重比
bian'su'xiang'qian'you'feng  -  变速箱前油封
jing'pin'zu'jian  -  精品组件
zhui'xing'du'sai  -  锥形堵塞
mei'shi'xiao'che  -  美式校车
jia'chuan'qi'che  -  嘉川汽车
di'pan'ce'gong'ji  -  地盘测功机
si'dang'tong'bu'qi  -  四档同步器
liang'fen'pin'la'ba  -  两分频喇叭
you'qian'ye'zi'ban'nei'chen  -  右前叶子板内衬
xi'huo'la'xian  -  熄火拉线
tu'lun'zhou'wei'zhi'gan'zhi'qi  -  凸轮轴位置感知器
yan'tai'guo'ji'che'zhan  -  烟台国际车展
qian'zhi'dong'bi  -  前制动臂
you'xiao'mo'ca'mian'ji  -  有效摩擦面积
qi'che'qi'pei'zhuan'ye'fu'wu  -  汽车汽配专业服务
zhong'duan'xiao'sheng'qi  -  中段消声器
jing'ling'ben'chi  -  精灵奔驰
fa'dong'ji'xia'dang'ban  -  发动机下挡板
qian'zhi'dong'ti'zhi'xiao  -  前制动蹄支销
qi'che'gao'wei'zhi'dong'deng  -  汽车高位制动灯
zhong'xing'qi'che'chi'ye  -  中兴汽车驰野
zhi'dong'qi'zhi'dong'li'fen'pei'xi'shu  -  制动器制动力分配系数
duo'lu'chuan'shu'kong'zhi'dan'yuan  -  多路传输控制单元
cha'ru'luo'mu  -  插入螺母
hou'gang'ban'xiao  -  后钢板销
chang'jian'qi'che'pin'pai  -  常见汽车品牌
fen'li'zhou'cheng'ka'huang  -  分离轴承卡簧
xiao'sheng'qi'qian'jin'qi'guan'zong'cheng  -  消声器前进气管总成
qi'che'de'ling'gong'li  -  汽车的零公里
ye'mao'sai  -  野猫赛
zhong'qiao'yuan'zhu'chi'lun'ke  -  中桥园柱齿轮壳
man'mu'dan  -  曼牡丹
feng'tian'xi'ye'na  -  丰田锡耶纳
er'shou'qi'che'an'jie'dai'kuan  -  二手汽车按揭贷款
ao'di'feng'dong'zhong'xin  -  奥迪风洞中心
qian'xia'dao'xiang'bi  -  前下导向臂
bian'niu'qi'wei'xiu'she'bei  -  变扭器维修设备
hou'wu'deng'kai'guan'zong'cheng  -  后雾灯开关总成
zhong'xing'qi'che'biao'zhi  -  中兴汽车标志
ya'qian'shi'zi'suo'cha'su'qi  -  牙嵌式自锁差速器
che'liang'wai'bai'zhi  -  车辆外摆值
che'zai'hou'zuo'yu'le'xi'tong  -  车载后座娱乐系统
fu'te'ai'hu  -  福特爱虎
qiang'zhi'shi'qu'zhou'xiang'tong'feng  -  强制式曲轴箱通风
zhong'jian'chuan'dong'zhou'zong'cheng  -  中间传动轴总成
qi'che'fang'zhui'wei'zhuang'zhi  -  汽车防追尾装置
dian'ping'gai'ban  -  电瓶盖板
suo'wei'tu'zhi  -  缩微图纸
fu'he'xing'xing'chi'lun  -  复合行星齿轮
you'hou'che'men'bo'li  -  右后车门玻璃
yi'qi'da'zhong'qi'che'ju'le'bu  -  一汽大众汽车俱乐部
xia'mao'qi'che'ke'yun'zhan  -  夏茅汽车客运站
nuan'feng'ji'chu'feng'kou  -  暖风机出风口
qi'che'ji'xie'zhi'tu  -  汽车机械制图
lun'zhao  -  轮罩
ying'guo'lao'si'lai'si'ji'tuan  -  英国劳斯莱斯集团
dao'che'shi'pin'ying'xiang  -  倒车视频影像
fu'lun'er  -  佛轮尔
che'tan'bai'fen'bai  -  车坛百分百
xuan'zhuan'fen'liu'fa  -  旋转分流阀
shi'gui'zhang'jin'lun  -  时规涨紧轮
zong'cheng'diao'zhuang'she'bei  -  总成吊装设备
ji'you'ya'li'gan'ying'qi  -  机油压力感应器
nei'shi'jing  -  内室镜
gao'yin'dao'mo  -  高音倒模
hou'wei'deng'zhi'jia  -  后尾灯支架
wu'xian'yao'kong'fang'dao'suo  -  无线遥控防盗锁
kong'qi'lv'xin'zong'cheng  -  空气滤芯总成
ji'li'ye'ta  -  吉里耶塔
che'shen'qing'xi'she'bei  -  车身清洗设备
zhe'jiang'che'wang  -  浙江车网
che'men'zhe'ye  -  车门折页
zi'dong'pai'dang'bian'su'xiang  -  自动排档变速箱
zhi'cao'pen'bo'che  -  植草喷播车
zhuan'zi'chuan'gan'qi  -  转子传感器
qi'che'yun'xing'zuo'ye'ji'hua  -  汽车运行作业计划
qi'che'dang'wei'shu  -  汽车挡位数
shou'ji'dong'fa  -  手继动阀
luo'tuo'dian'ping  -  骆驼电瓶
pian'xin'zhou'wei'zhi'chuan'gan'qi  -  偏心轴位置传感器
